一	一,壹	一,壹
丁	丁	丁
七	七,柒,漆	七,柒,漆
万	万,萬,卍	万
丈	丈	丈
三	三,參	三,叁,参
上	上	上
下	下	下
不	不	不
与	与,與	与
丐	丐	丐
丑	丑,醜	丑
且	且	且
丕	丕,仳	丕,仳
世	世	世
丘	丘,坵	丘
丙	丙	丙
丞	丞	丞
中	中,塚,冢	中,冢
串	串	串
丸	丸	丸
丹	丹	丹
主	主	主
乃	乃,迺	乃
久	久	久
之	之	之
乍	乍	乍
乎	乎	乎
乏	乏	乏
乖	乖	乖
乘	乘	乘
乙	乙	乙
九	九,玖	九,玖
乞	乞	乞
也	也	也
乳	乳	乳
乾	乾,干,幹,榦	乾,干
了	了,瞭,暸	了
予	予,豫,余,餘	予,豫,余,馀
事	事	事
二	二,貳	二,贰
于	于,於	于,於
云	云,雲	云
互	互	互
五	五,伍	五,伍
井	井,丼	井
些	些	些
亟	亟	亟
亡	亡	亡
亢	亢	亢
交	交	交
亥	亥	亥
亦	亦	亦
亨	亨	亨
享	享	享
京	京	京
亭	亭	亭
亮	亮	亮
亳	亳	亳
人	人	人,亻
什	什,甚	什,甚
仁	仁	仁
仂	仂	仂
仄	仄,庂	仄
仆	仆,僕	仆
仇	仇,讎	仇,雠
今	今	今
介	介	介
仍	仍	仍
仔	仔	仔
仕	仕	仕
他	他,她,牠	他,她
仗	仗	仗
付	付	付
仙	仙,僊	仙
仝	仝,同,衕	仝,同
仞	仞	仞
仟	仟,千,韆,阡	仟,千,阡
代	代	代
令	令	令
以	以	以
仰	仰	仰
仲	仲	仲
件	件	件
价	价,價	价
任	任	任
企	企	企
伉	伉	伉
伊	伊	伊
伍	伍,五	伍,五
伎	伎	伎
伏	伏	伏
伐	伐	伐
休	休	休
伯	伯	伯
估	估	估
伴	伴	伴
伶	伶	伶
伸	伸,抻	伸,抻
伺	伺	伺
似	似	似
伽	伽	伽
佃	佃	佃
但	但	但
位	位	位
低	低	低
住	住	住
佐	佐	佐
佑	佑,祐	佑
体	体,體	体
何	何	何
佗	佗,它	佗,它
余	余,餘,予	余,予,馀
佚	佚	佚
佛	佛,彿	佛
作	作	作
佝	佝	佝
佞	佞	佞
佩	佩,珮	佩
佯	佯	佯
佰	佰,百	佰,百
佳	佳	佳
佶	佶	佶
佻	佻	佻
佼	佼	佼
使	使	使
侃	侃	侃
侈	侈	侈
例	例	例
侍	侍	侍
侏	侏	侏
侑	侑	侑
供	供	供
依	依	依
侮	侮	侮
侯	侯	侯
侵	侵	侵
便	便	便
促	促	促
俄	俄	俄
俊	俊	俊
俎	俎	俎
俐	俐	俐
俑	俑	俑
俗	俗	俗
俘	俘	俘
俚	俚	俚
保	保	保
俟	俟	俟
信	信	信
修	修,脩	修
俯	俯,頫	俯
俳	俳	俳
俸	俸	俸
俺	俺	俺
俾	俾	俾
倍	倍	倍
倏	倏	倏
倒	倒	倒
倔	倔	倔
候	候	候
倚	倚	倚
借	借,藉	借,藉
倡	倡	倡
倥	倥	倥
倦	倦	倦
倨	倨	倨
倩	倩	倩
倪	倪	倪
倬	倬	倬
倭	倭	倭
偃	偃	偃
假	假	假
偈	偈	偈
偏	偏	偏
偕	偕	偕
做	做,作	做,作
停	停,仃	停,仃
健	健	健
偶	偶	偶
傀	傀	傀
傅	傅	傅
傍	傍,旁	傍,旁
催	催	催
傲	傲	傲
像	像,象	像,象
僖	僖	僖
僚	僚	僚
僧	僧	僧
僭	僭,僣	僭
僮	僮	僮
僵	僵,殭	僵
僻	僻	僻
儒	儒	儒
儡	儡,酹	儡,酹
儿	儿,兒	儿
兀	兀,兀	兀
允	允	允
元	元	元
兄	兄	兄
充	充	充
兆	兆	兆
先	先,尖	先,尖
光	光	光
克	克,剋	克
免	免	免
兔	兔,菟	兔,菟
党	党,黨	党
兜	兜	兜
兢	兢	兢
入	入	入
全	全	全
八	八,捌	八,捌
公	公	公
六	六,陸	六,陆
兮	兮	兮
共	共	共
兵	兵	兵
其	其,丌	其,丌
具	具	具
典	典	典
兼	兼	兼
冀	冀	冀
冉	冉	冉
再	再	再
冒	冒	冒
冕	冕,本	冕,本
冗	冗	冗
冠	冠	冠
冢	冢,塚	冢
冤	冤	冤
冥	冥	冥
冬	冬,鼕	冬
冰	冰	冰,冫
冱	冱,沍	冱
冶	冶	冶
冷	冷	冷
冽	冽,洌	冽,洌
凄	凄,淒,悽	凄
准	准,準,淮	准,淮
凋	凋,雕,彫,鵰	凋,雕
凌	凌,淩	凌
凝	凝	凝
几	几,幾	几
凡	凡	凡
凰	凰	凰
凵	凵	凵
凶	凶,兇	凶
凸	凸	凸
凹	凹	凹
出	出,齣	出
函	函	函
刀	刀	刀,刂
刃	刃	刃
分	分,份	分,份
切	切	切
刈	刈	刈
刊	刊	刊
刎	刎	刎
刑	刑	刑
列	列	列
初	初	初
判	判	判
利	利	利
刮	刮,颳	刮
到	到	到
刳	刳	刳
制	制,製	制
刷	刷	刷
券	券	券
刺	刺,莿	刺
刻	刻	刻
剃	剃,薙	剃
削	削	削
剌	剌	剌
前	前	前
剔	剔	剔
剖	剖	剖
剞	剞	剞
剩	剩,賸	剩
剪	剪,翦	剪,翦
副	副	副
割	割	割
剽	剽	剽
剿	剿,勦	剿
劈	劈,擗	劈,擗
力	力	力
功	功	功
加	加	加
劣	劣	劣
助	助	助
努	努	努
劫	劫	劫
劬	劬	劬
劭	劭	劭
劾	劾	劾
勃	勃,艴	勃,艴
勇	勇	勇
勉	勉	勉
勒	勒	勒
勘	勘	勘
募	募	募
勤	勤,懃	勤
勺	勺	勺
勾	勾,句	勾,句
勿	勿	勿
包	包	包,勹
匆	匆	匆
匈	匈,胸	匈,胸
匍	匍	匍
匏	匏,瓟	匏
匐	匐	匐
匕	匕	匕
化	化	化
北	北	北
匙	匙,鍉	匙
匚	匚	匚
匝	匝	匝
匠	匠	匠
匡	匡,劻	匡
匣	匣	匣
匪	匪	匪
匹	匹,疋	匹,疋
匿	匿	匿
十	十,拾	十,拾
千	千,韆,仟	千,仟
卅	卅	卅
升	升,昇,陞	升
午	午	午
卉	卉,芔	卉
半	半	半
卑	卑	卑
卒	卒	卒
卓	卓,棹	卓,棹
南	南	南
博	博	博
卜	卜,蔔	卜
卞	卞	卞
占	占,佔	占
卦	卦	卦
卮	卮	卮
卯	卯	卯
印	印	印
危	危	危
即	即	即
卵	卵	卵
卷	卷,捲	卷
卸	卸	卸
卿	卿	卿
厂	厂,廠	厂
厄	厄,阨	厄
厘	厘,釐,廛	厘,廛
厚	厚	厚
原	原	原
厥	厥	厥
去	去	去
又	又	又
叉	叉,釵,扠	叉,钗
及	及	及
友	友	友
反	反	反
叔	叔	叔
取	取	取
受	受	受
叛	叛	叛
叟	叟	叟
口	口	口
古	古	古
句	句	句
叨	叨,饕	叨,饕
叩	叩	叩
只	只,衹,隻,祇,止,子	只,止,子
叫	叫	叫
召	召	召
叭	叭	叭
叮	叮	叮
可	可	可
台	台,檯,臺,颱	台
叱	叱	叱
史	史	史
右	右	右
司	司	司
吁	吁,籲	吁
吃	吃,喫	吃
各	各	各
合	合,閤,闔,郃	合,阖
吉	吉	吉
吊	吊,弔	吊
同	同,衕,仝	同,仝
名	名	名
后	后,後	后,後
吏	吏	吏
吐	吐	吐
向	向,曏,嚮	向
君	君	君
吝	吝	吝
吟	吟	吟
吠	吠	吠
否	否	否
吩	吩	吩
含	含,唅	含
听	听,聽	听
吭	吭	吭
吮	吮	吮
吸	吸	吸
吹	吹	吹
吻	吻,呡	吻
吼	吼	吼
吾	吾	吾
呀	呀	呀
呆	呆,獃,騃	呆
呈	呈	呈
告	告	告
周	周,週,賙	周
呱	呱	呱,哌
味	味	味
呵	呵,訶	呵,诃
呶	呶	呶
呷	呷	呷
呻	呻	呻
呼	呼,謼	呼
命	命	命
咀	咀,嘴,觜	咀,嘴,觜
咄	咄	咄
咆	咆	咆
咋	咋	咋
和	和,龢	和
咎	咎	咎
咐	咐	咐
咒	咒	咒
咨	咨,諮	咨,谘
咫	咫	咫
咬	咬	咬
咯	咯,詻,喀	咯,喀
咳	咳,欬	咳
咸	咸,鹹	咸
咽	咽,嚥	咽
哀	哀	哀
品	品	品
哂	哂	哂,吲
哄	哄,鬨	哄
哇	哇	哇
哈	哈	哈
哉	哉	哉
哥	哥	哥
哦	哦	哦
哨	哨	哨
哩	哩	哩
哭	哭	哭
哮	哮	哮
哲	哲,悊	哲
哺	哺,餔	哺
哽	哽	哽
唆	唆	唆
唇	唇,脣	唇
唏	唏	唏
唐	唐	唐
唔	唔	唔
售	售	售
唯	唯	唯
唱	唱	唱
唳	唳	唳
唾	唾	唾
啄	啄	啄
商	商	商
啖	啖,啗,噉	啖
啜	啜,欼,歠	啜
啻	啻	啻
啼	啼	啼
啾	啾	啾
喀	喀,咯	喀,咯
喃	喃,諵	喃
善	善	善
喇	喇	喇
喉	喉	喉
喊	喊	喊
喋	喋	喋
喘	喘	喘
喙	喙	喙
喜	喜,歖	喜
喝	喝	喝
喟	喟	喟
喧	喧,諠	喧
嗄	嗄	嗄
嗅	嗅	嗅
嗔	嗔	嗔
嗜	嗜	嗜
嗟	嗟	嗟
嗣	嗣	嗣
嗤	嗤	嗤
嗷	嗷	嗷
嗽	嗽	嗽
嗾	嗾	嗾
嘉	嘉	嘉
嘛	嘛	嘛
嘲	嘲	嘲
嘴	嘴,咀,觜	嘴,咀,觜
嘶	嘶	嘶
噌	噌	噌
噎	噎	噎
噤	噤	噤
器	器	器
噪	噪,譟,喿	噪
噫	噫	噫
噬	噬	噬
嚆	嚆	嚆
嚏	嚏	嚏
嚼	嚼	嚼
囗	囗	囗
囚	囚	囚
四	四,肆	四,肆
回	回,迴	回
因	因	因
困	困,睏,綑	困
囹	囹	囹
固	固	固
囿	囿	囿
圃	圃	圃
圄	圄	圄
圈	圈	圈
圉	圉	圉
圜	圜	圜
土	土	土
在	在	在
圭	圭,珪	圭
地	地	地
圻	圻,垠	圻,垠
址	址,阯	址
均	均	均
坊	坊	坊
坎	坎,埳	坎
坏	坏,壞,坯	坏,坯
坐	坐,座	坐,座
坑	坑,阬	坑
坡	坡,陂	坡,陂
坤	坤	坤
坦	坦	坦
坩	坩	坩
坪	坪	坪
垂	垂	垂
型	型	型
垓	垓,陔	垓,陔
垠	垠,圻	垠,圻
垢	垢	垢
垣	垣	垣
垤	垤	垤
埃	埃	埃
埋	埋	埋
城	城	城
埒	埒	埒
埔	埔	埔
域	域,譽	域,誉
埠	埠	埠
埴	埴	埴
培	培	培
基	基,拯	基,拯
堀	堀	堀
堂	堂	堂
堆	堆	堆
堋	堋	堋
堙	堙,垔	堙
堡	堡	堡
堤	堤,隄	堤
堪	堪	堪
堰	堰	堰
堵	堵	堵
塑	塑	塑
塔	塔	塔
塘	塘	塘
塞	塞	塞
填	填	填
塾	塾,孰	塾,孰
境	境	境
墅	墅	墅
墓	墓	墓
墟	墟	墟
墨	墨	墨
壁	壁	壁
壅	壅	壅
壑	壑	壑
壕	壕	壕
壤	壤	壤
士	士	士
壬	壬	壬
壹	壹,搋,一	壹,搋,一
夏	夏	夏
夕	夕	夕
外	外,舀	外,舀
夙	夙	夙
多	多	多
夜	夜	夜
夥	夥,伙	夥,伙
大	大	大
天	天	天
太	太	太
夫	夫,伕	夫
夭	夭,殀	夭
央	央	央
失	失	失
夷	夷	夷
夸	夸,誇	夸
奄	奄	奄
奇	奇	奇
奈	奈,柰	奈,柰
奉	奉	奉
奎	奎	奎
奏	奏	奏
契	契	契
奔	奔	奔
奕	奕,弈	奕,弈
套	套	套
奘	奘	奘
奚	奚	奚
奠	奠	奠
奢	奢	奢
女	女	女
奴	奴	奴
奸	奸,姦	奸
好	好	好
妁	妁	妁
如	如	如
妃	妃	妃
妄	妄	妄
妊	妊	妊
妍	妍	妍
妓	妓	妓
妖	妖	妖
妙	妙,玅	妙
妣	妣	妣
妥	妥	妥
妨	妨	妨
妲	妲	妲
妹	妹	妹
妻	妻	妻
妾	妾	妾
姆	姆,姥,佬	姆,姥,佬
始	始	始
姐	姐,姊	姐,姊
姑	姑	姑
姓	姓	姓
委	委	委
姚	姚	姚
姜	姜,薑	姜
姥	姥,姆	姥,姆
姨	姨	姨
姻	姻	姻
姿	姿	姿
威	威	威
娃	娃	娃
娉	娉	娉
娑	娑	娑
娘	娘,孃	娘
娜	娜	娜
娟	娟	娟
娠	娠,煖	娠
娥	娥	娥
娩	娩	娩
娶	娶	娶
娼	娼	娼
婀	婀	婀
婆	婆	婆
婉	婉	婉
婚	婚	婚
婢	婢	婢
婪	婪	婪
婿	婿	婿
媒	媒	媒
媚	媚	媚
媛	媛	媛
媾	媾	媾
嫁	嫁	嫁
嫂	嫂	嫂
嫉	嫉	嫉
嫌	嫌	嫌
嫖	嫖	嫖
嫡	嫡	嫡
嫣	嫣	嫣
嫦	嫦,姮	嫦
嫩	嫩	嫩
嬉	嬉	嬉
嬖	嬖	嬖
嬲	嬲,惱	嬲,恼
孀	孀,霜	孀,霜
子	子,只,衹,隻,祇	子,只
孑	孑	孑
孔	孔	孔
孕	孕	孕
字	字	字
存	存	存
孚	孚,孵	孚,孵
孛	孛,柏	孛,柏
孜	孜	孜
孝	孝	孝
孟	孟	孟
季	季	季
孤	孤	孤
孥	孥	孥
孩	孩	孩
孰	孰,塾	孰,塾
孱	孱	孱
孳	孳	孳
孵	孵,孚	孵,孚
孺	孺	孺
它	它,牠,佗	它,佗
宅	宅	宅
宇	宇	宇
守	守	守
安	安	安
宋	宋	宋
完	完,煙	完,烟
宏	宏	宏
宕	宕	宕
宗	宗	宗
官	官	官
宙	宙	宙
定	定	定
宛	宛	宛
宜	宜	宜
客	客	客
宣	宣	宣
室	室	室
宥	宥	宥
宦	宦	宦
宰	宰	宰
害	害	害
宴	宴,讌	宴
宵	宵	宵
家	家,傢	家
宸	宸	宸
容	容	容
宿	宿	宿
寂	寂	寂
寄	寄	寄
寅	寅	寅
密	密	密
寇	寇	寇
富	富	富
寐	寐	寐
寒	寒	寒
寓	寓	寓
寞	寞	寞
察	察	察
寡	寡,關	寡,关
寤	寤	寤
寥	寥	寥
寨	寨,砦	寨,砦
寮	寮	寮
寰	寰	寰
寸	寸,吋	寸
寺	寺	寺
封	封	封
射	射	射
尉	尉,熨	尉,熨
尊	尊	尊
小	小	小
少	少	少
尖	尖	尖
尚	尚	尚
尢	尢	尢
尤	尤	尤
就	就	就
尸	尸,屍	尸
尹	尹	尹
尺	尺,呎	尺
尻	尻	尻
尼	尼	尼
尾	尾	尾
尿	尿,溺	尿,溺
局	局,侷,跼,挶	局
屁	屁	屁
居	居	居
屈	屈	屈
屋	屋	屋
屎	屎	屎
屏	屏,摒	屏,摒
屐	屐	屐
屑	屑	屑
展	展	展
屠	屠	屠
履	履	履
屮	屮	屮
屯	屯	屯
山	山	山
屹	屹	屹
岌	岌	岌
岐	岐,歧	岐,歧
岑	岑	岑
岔	岔	岔
岩	岩,巖,嵒,碞	岩
岫	岫	岫
岬	岬	岬
岱	岱	岱
岳	岳,嶽	岳
岷	岷	岷
岸	岸	岸
峙	峙	峙
峨	峨	峨
峪	峪	峪
峭	峭	峭
峰	峰	峰
峻	峻	峻
崇	崇	崇
崎	崎,埼,碕	崎
崔	崔,磪	崔
崖	崖	崖
崛	崛	崛
崩	崩	崩
嵋	嵋	嵋
嵌	嵌	嵌
嵩	嵩,崧	嵩,崧
嵬	嵬	嵬
嵯	嵯	嵯
嶂	嶂	嶂
嶝	嶝,磴	嶝,磴
嶷	嶷	嶷
巍	巍,魏	巍,魏
川	川	川,巛
州	州	州
巡	巡	巡
工	工	工
左	左	左
巧	巧	巧
巨	巨,鉅	巨,钜
巫	巫	巫
差	差	差
己	己	己
已	已	已
巳	巳	巳
巴	巴,笆	巴,笆
巷	巷	巷
巽	巽	巽
巾	巾	巾
市	市	市
布	布,佈	布
帆	帆,拚	帆,拚
希	希,稀	希,稀
帑	帑	帑
帖	帖	帖
帙	帙	帙
帚	帚	帚
帛	帛	帛
帝	帝	帝
席	席,蓆	席
帷	帷	帷
常	常	常
帽	帽	帽
幄	幄	幄
幅	幅	幅
幌	幌	幌
幔	幔	幔
幕	幕,幙	幕
幡	幡,旛	幡
幢	幢,橦	幢
干	干,乾,幹,榦	干,乾
平	平	平
年	年	年
并	并,並,併	并
幸	幸,倖,囟,曰	幸,囟,曰
幻	幻	幻
幼	幼,么	幼,幺,么
幽	幽	幽,凼
庄	庄,莊	庄
庇	庇	庇
床	床	床
序	序	序
底	底	底
庖	庖	庖
店	店,坫	店,坫
庚	庚	庚
府	府	府
庠	庠	庠
度	度,廓	度,廓
座	座,坐	座,坐
庭	庭	庭
庵	庵,菴	庵
庶	庶	庶
康	康	康
庸	庸	庸
廉	廉	廉
廊	廊	廊
廓	廓,度	廓,度
廖	廖	廖
廛	廛	廛
廨	廨	廨
延	延	延
廷	廷	廷
建	建	建
廾	廾,廿	廾,廿
廿	廿,廾,卄	廿,廾
弁	弁,瓣,辦,辯,辮,辨	弁,瓣,办,辩,辫,辨
弄	弄,瘧	弄,疟
弊	弊	弊
弋	弋	弋
式	式	式
弓	弓	弓
引	引	引
弗	弗	弗
弘	弘	弘
弛	弛	弛
弟	弟	弟
弦	弦,絃	弦
弧	弧	弧
弩	弩	弩
弭	弭	弭
弱	弱	弱
弼	弼	弼
彖	彖	彖
彗	彗,篲	彗
彝	彝	彝
形	形	形
彩	彩,綵	彩
彪	彪	彪
彬	彬,份,斌	彬,份,斌
彭	彭	彭
彰	彰	彰
影	影	影
彳	彳	彳
彷	彷,仿,倣,髣,徬	彷,仿
役	役	役
彼	彼	彼
往	往	往
征	征,徵	征,徵
徂	徂	徂
待	待	待
徇	徇,侚	徇
很	很	很
徊	徊,佪	徊
律	律	律
後	後,后	後,后
徐	徐	徐
徒	徒	徒
得	得	得
徘	徘	徘
徙	徙	徙
御	御,禦,馭	御,驭
徨	徨,遑	徨,遑
循	循	循
徭	徭,傜	徭
微	微	微
徼	徼	徼
徽	徽	徽
心	心	心,忄
必	必	必
忌	忌	忌
忍	忍	忍
忖	忖	忖
志	志,誌	志
忘	忘	忘
忙	忙	忙
忝	忝	忝
忠	忠	忠
忤	忤,啎,迕	忤,迕
快	快	快
忱	忱	忱
念	念,唸	念
忸	忸	忸
忻	忻,欣,訢	忻,欣
忽	忽	忽
忿	忿	忿
怎	怎	怎
怏	怏	怏
怒	怒	怒
怕	怕	怕
怖	怖	怖
怙	怙	怙
怛	怛	怛
怜	怜,憐	怜
思	思	思
怠	怠	怠
怡	怡	怡
急	急	急
怦	怦	怦
性	性	性
怨	怨	怨
怩	怩	怩
怪	怪	怪
怫	怫	怫
怯	怯	怯
恁	恁	恁
恂	恂,悛	恂,悛
恃	恃	恃
恍	恍,怳	恍
恐	恐	恐
恕	恕	恕
恙	恙	恙
恚	恚	恚
恢	恢	恢
恣	恣	恣
恤	恤,卹	恤
恨	恨	恨
恩	恩,摁	恩,摁
恪	恪	恪
恫	恫	恫
恬	恬	恬
恭	恭	恭
息	息	息
恰	恰	恰
悃	悃	悃
悄	悄	悄
悉	悉	悉
悌	悌	悌
悍	悍	悍
悒	悒	悒
悔	悔	悔
悖	悖	悖
悚	悚	悚
悛	悛,恂	悛,恂
悟	悟	悟
悠	悠	悠
患	患	患
悲	悲	悲
悴	悴	悴
悸	悸	悸
悼	悼	悼
情	情	情
惆	惆	惆
惑	惑	惑
惘	惘	惘
惚	惚	惚
惜	惜	惜
惟	惟	惟
惠	惠	惠
惰	惰	惰
想	想	想
惴	惴	惴
惶	惶	惶
惹	惹	惹
惺	惺,醒	惺,醒
愀	愀	愀
愁	愁	愁
愆	愆	愆
愈	愈,癒,愉,瘉	愈,愉
愉	愉,愈,癒	愉,愈
愍	愍,憫	愍,悯
愎	愎	愎
意	意	意
愕	愕	愕
愚	愚	愚
感	感	感
愧	愧,媿	愧
愿	愿,願	愿
慈	慈	慈
慊	慊	慊
慌	慌	慌
慎	慎	慎
慕	慕	慕
慝	慝	慝
慢	慢	慢
慧	慧	慧
慨	慨	慨
慰	慰	慰
慵	慵	慵
慷	慷	慷
憎	憎,贈	憎,赠
憔	憔	憔
憧	憧	憧
憩	憩	憩
憬	憬	憬
憾	憾	憾
懈	懈	懈
懊	懊	懊
懋	懋	懋
懦	懦	懦
懿	懿	懿
戈	戈	戈
戊	戊	戊
戌	戌	戌
戍	戍	戍
戎	戎	戎
成	成	成
我	我	我
戒	戒	戒
或	或	或
戚	戚,慼	戚
戛	戛	戛
戟	戟	戟
戡	戡	戡
截	截	截
戮	戮,僇	戮
戳	戳	戳
戴	戴	戴
房	房	房
所	所	所
扁	扁,萹,稨,碥,艑	扁,碥
扇	扇,煽	扇,煽
扈	扈	扈
扉	扉,屝	扉
手	手	手,扌
才	才,纔,財	才,财
扎	扎,紮	扎
打	打	打
托	托,託,拓	托,拓
扛	扛,摃	扛
扣	扣,釦	扣
扮	扮	扮
扶	扶	扶
批	批	批
扼	扼,搤	扼
找	找	找
承	承	承
技	技	技
抄	抄	抄
抉	抉	抉
把	把	把
抑	抑	抑
抒	抒	抒
抓	抓	抓
投	投	投
抖	抖	抖
抗	抗	抗
折	折,翼	折,翼
披	披	披
抬	抬	抬
抱	抱,抔	抱
抵	抵,扺,牴	抵
抹	抹	抹
抻	抻,伸	抻,伸
押	押	押
抽	抽	抽
拂	拂	拂
拆	拆,責	拆,责
拇	拇	拇
拈	拈,敁	拈
拉	拉	拉
拊	拊,撫	拊,抚
拌	拌	拌
拍	拍	拍
拐	拐,枴	拐
拒	拒	拒
拓	拓,托,託	拓,托
拔	拔	拔
拗	拗	拗
拘	拘	拘
拙	拙	拙
招	招	招
拜	拜	拜
括	括	括
拭	拭	拭
拮	拮	拮
拯	拯,基	拯,基
拱	拱	拱
拳	拳	拳
拶	拶	拶
拷	拷	拷
拾	拾,十	拾,十
拿	拿,拏,挐	拿
持	持	持
挂	挂,掛	挂
指	指	指
挈	挈	挈
按	按,搵	按
挑	挑	挑
挨	挨	挨
挫	挫,繲	挫
振	振	振
挺	挺	挺
挽	挽,輓,掇	挽,掇
捉	捉,杓	捉,杓
捌	捌,八	捌,八
捍	捍,扞	捍
捏	捏	捏
捐	捐	捐
捕	捕	捕
捧	捧	捧
捩	捩	捩
据	据,據	据
捶	捶,搥,箠	捶
捷	捷	捷
捺	捺	捺
捻	捻,撚	捻
掀	掀	掀
授	授	授
掉	掉,棹	掉,棹
掌	掌	掌
掎	掎	掎
掏	掏,搯	掏
排	排	排
掖	掖	掖
掘	掘,撅	掘,撅
掠	掠	掠
探	探	探
掣	掣	掣
接	接	接
控	控	控
推	推	推
掩	掩,揜	掩,揞
措	措	措
掬	掬,匊	掬
掾	掾	掾
揄	揄	揄
揆	揆	揆
揉	揉	揉
描	描	描
提	提	提
插	插,扱	插
揖	揖	揖
握	握	握
揣	揣	揣
揩	揩	揩
援	援	援
揶	揶	揶
搏	搏	搏
搓	搓	搓
搜	搜	搜
搦	搦	搦
搬	搬,搫	搬
搭	搭,搨,撘	搭
搴	搴	搴
摘	摘	摘
摧	摧	摧
摩	摩	摩
摸	摸	摸
摺	摺	摺
撒	撒	撒
撕	撕	撕
撞	撞	撞
撤	撤	撤
撩	撩	撩
播	播	播
撮	撮	撮
撰	撰,譔	撰
撼	撼	撼
擂	擂	擂
擅	擅	擅
操	操	操
擒	擒	擒
擘	擘	擘
擢	擢	擢
擦	擦,抆	擦
攀	攀,扳	攀,扳
攘	攘	攘
攫	攫	攫
支	支	支
收	收	收
攸	攸	攸
改	改	改
攻	攻	攻
放	放	放
政	政	政
故	故	故
效	效,傚	效
敏	敏	敏
救	救	救
敕	敕	敕
敖	敖	敖
教	教	教
敝	敝	敝
敞	敞	敞
敢	敢	敢
散	散	散
敦	敦,惇	敦
敬	敬	敬
敲	敲,搞	敲,搞
整	整	整
敷	敷,尃	敷
文	文,穩	文,稳
斌	斌,彬	斌,彬
斐	斐	斐
斑	斑	斑
斗	斗,鬥	斗,门
料	料	料
斛	斛	斛
斜	斜	斜
斟	斟	斟
斡	斡	斡
斤	斤,觔	斤
斥	斥	斥
斧	斧	斧
斫	斫	斫
斯	斯	斯
新	新	新
方	方	方
於	於,于,虧	於,于,亏
施	施	施
旁	旁,傍,徬	旁,傍
旃	旃	旃
旄	旄	旄
旅	旅	旅
旆	旆	旆
旋	旋	旋
旌	旌	旌
族	族	族
旒	旒	旒
旗	旗,旂	旗
既	既	既
日	日	日
旦	旦,蛋	旦,蛋
旨	旨	旨
早	早	早
旬	旬	旬
旭	旭,旯	旭,旯
旱	旱	旱
旺	旺	旺
昂	昂,卬	昂
昃	昃	昃
昆	昆,崑	昆
昊	昊	昊
昌	昌	昌
明	明	明
昏	昏	昏
易	易	易
昔	昔	昔
星	星	星
映	映	映
春	春	春
昧	昧	昧
昨	昨	昨
昭	昭	昭
是	是	是
昴	昴	昴
昵	昵,暱	昵
昶	昶,暢	昶,畅
晁	晁,朝	晁,朝
晃	晃	晃
晏	晏	晏
晒	晒,曬	晒
晟	晟	晟
晤	晤	晤
晦	晦	晦
晨	晨	晨
普	普	普
景	景	景
晰	晰,晢	晰
晴	晴	晴
晶	晶	晶
智	智	智
暄	暄	暄
暇	暇	暇
暑	暑	暑
暖	暖,煖,娠	暖,娠
暗	暗,闇,晻	暗
暝	暝	暝
暮	暮	暮
暴	暴,虣	暴
暹	暹	暹
暾	暾	暾
曙	曙	曙
曜	曜,燿,耀	曜,耀
曝	曝	曝
曦	曦,晞	曦
曩	曩	曩
曰	曰	曰
曲	曲	曲
曳	曳,拽,抴	曳,拽
更	更	更
曷	曷	曷
曹	曹	曹
曼	曼	曼
曾	曾	曾
替	替	替
最	最	最
月	月	月
有	有	有
朋	朋	朋
服	服	服
朔	朔	朔
朕	朕	朕
朗	朗	朗
望	望,朢	望
朝	朝,晁	朝,晁
期	期,逞	期,逞
朦	朦,蒙,濛,矇	朦,蒙
木	木	木
未	未	未
末	末	末
本	本	本
札	札,劄	札
朱	朱,硃	朱
朴	朴,樸	朴
机	机,機	机
朽	朽	朽
杆	杆,桿	杆
杉	杉	杉
李	李	李
杏	杏	杏
材	材	材
村	村	村
杓	杓,捉	杓,捉
杖	杖	杖
杜	杜	杜
杞	杞	杞
束	束	束
杠	杠,槓	杠
杪	杪	杪
杭	杭	杭
杯	杯,盃	杯
杰	杰,傑	杰
杲	杲	杲
杳	杳	杳
杵	杵	杵
杷	杷,朳	杷
杼	杼	杼
松	松,鬆	松
板	板,闆,版	板,版
枇	枇	枇
枉	枉	枉
枋	枋	枋
析	析	析
枕	枕	枕
林	林	林
枚	枚	枚
果	果	果
枝	枝	枝
枯	枯	枯
枳	枳	枳
架	架	架
枷	枷	枷
枸	枸	枸
柁	柁,舵	柁,舵
柄	柄	柄
柏	柏,孛	柏,孛
某	某	某,厶
柑	柑	柑
染	染	染
柔	柔	柔
柘	柘	柘
柚	柚	柚
柝	柝	柝
柞	柞	柞
柢	柢	柢
柩	柩	柩
柬	柬,揀	柬,拣
柯	柯	柯
柱	柱	柱
柳	柳,檉	柳,柽
柴	柴,茈	柴,茈
柿	柿	柿
栓	栓	栓
栖	栖,棲	栖
栗	栗,慄	栗
校	校	校
栩	栩	栩
株	株	株
栲	栲	栲
核	核,覈	核
根	根	根
格	格	格
栽	栽	栽
桀	桀	桀
桁	桁,航	桁,航
桂	桂	桂
桃	桃	桃
框	框	框
案	案	案
桎	桎	桎
桐	桐	桐
桑	桑	桑
桓	桓	桓
桔	桔	桔
桴	桴	桴
桶	桶	桶
桷	桷	桷
梁	梁,樑	梁
梃	梃	梃
梅	梅	梅
梏	梏	梏
梓	梓	梓
梗	梗	梗
梢	梢	梢
梧	梧	梧
梨	梨	梨
梭	梭	梭
梯	梯	梯
械	械	械
梳	梳	梳
梵	梵	梵
棉	棉	棉
棋	棋	棋
棍	棍	棍
棒	棒	棒
棕	棕	棕
棘	棘	棘
棚	棚	棚
棠	棠	棠
棣	棣	棣
森	森	森
棹	棹,桌,櫂,卓	棹,桌,卓
棺	棺	棺
椅	椅	椅
椋	椋	椋
植	植	植
椎	椎,槌	椎,槌
椒	椒,茭	椒,茭
椰	椰	椰
椴	椴	椴
椹	椹,葚	椹,葚
椽	椽	椽
椿	椿	椿
楔	楔	楔
楚	楚	楚
楝	楝	楝
楞	楞,棱,稜	楞,棱
楠	楠	楠
楫	楫	楫
楮	楮	楮
楷	楷	楷
楸	楸	楸
楹	楹	楹
概	概	概
榔	榔	榔
榕	榕	榕
榛	榛,親	榛,亲
榜	榜	榜
榧	榧,棐	榧
榱	榱	榱
榴	榴	榴
榻	榻	榻
槁	槁,薧	槁
槊	槊,鎙	槊
槌	槌,棰,椎	槌,棰,椎
槎	槎,楂	槎,楂
槐	槐	槐
槭	槭	槭
槲	槲	槲
槽	槽	槽
槿	槿	槿
樊	樊	樊
樗	樗	樗
樟	樟	樟
模	模	模
樵	樵	樵
樽	樽,節,墫	樽,节
橄	橄	橄
橇	橇	橇,鞒
橘	橘	橘
橙	橙	橙
橡	橡	橡
檀	檀	檀
檄	檄	檄
檎	檎	檎
檐	檐,簷	檐
檗	檗,蘗,櫱	檗,蘖
檠	檠	檠
檬	檬	檬
欠	欠,缺	欠,缺
次	次	次
欣	欣,訢,忻	欣,忻
欲	欲,慾	欲
欷	欷	欷
欹	欹,猗	欹,猗
欺	欺	欺
款	款	款
歃	歃	歃
歇	歇	歇
歉	歉,欠	歉,欠
歌	歌	歌
歙	歙	歙
止	止,只,衹,隻,祇	止,只
正	正	正
此	此	此
武	武	武
歪	歪	歪
歹	歹	歹
死	死	死
殃	殃	殃
殄	殄	殄
殆	殆	殆
殉	殉,侚,徇	殉,徇
殊	殊	殊
殍	殍,莩	殍,莩
殖	殖	殖
殪	殪	殪
殳	殳,杸	殳
段	段	段
殷	殷,慇	殷
殿	殿	殿
毅	毅	毅
毋	毋	毋
母	母	母
毒	毒	毒
毓	毓,育	毓,育
比	比	比
毛	毛	毛
毫	毫	毫
毯	毯	毯
毳	毳	毳
氏	氏	氏
民	民	民
氓	氓,甿	氓
气	气,氣	气
氛	氛	氛
氤	氤,絪	氤
水	水	水,氵
永	永	永
汀	汀	汀
汁	汁	汁
求	求	求
汐	汐	汐
汕	汕	汕
汗	汗	汗
汝	汝	汝
汞	汞	汞
江	江	江
池	池	池
汨	汨,汩	汨,汩
汪	汪	汪
汰	汰	汰
汲	汲,伋	汲
汽	汽	汽
汾	汾	汾
沁	沁	沁
沂	沂	沂
沃	沃	沃
沈	沈,瀋,沉	沈,沉,渖
沌	沌	沌
沐	沐	沐
沓	沓	沓
沙	沙	沙
沛	沛	沛
沫	沫	沫
沮	沮	沮
沱	沱	沱,沲
河	河	河
沸	沸	沸
油	油	油
治	治	治
沼	沼	沼
沽	沽	沽
沾	沾,霑	沾
沿	沿	沿
泄	泄,洩,渫	泄,渫
泅	泅	泅
泉	泉	泉
泊	泊,濼	泊,泺
泌	泌	泌
泓	泓	泓
法	法	法
泗	泗	泗
泛	泛,汎,氾	泛
泡	泡,箔	泡,箔
波	波	波
泣	泣	泣
泥	泥,坭	泥,坭
注	注,註	注
泯	泯	泯
泰	泰	泰
泱	泱	泱
泳	泳	泳
洋	洋	洋
洌	洌,冽	洌,冽
洒	洒,灑	洒
洗	洗	洗
洙	洙	洙
洛	洛	洛
洞	洞,峒	洞,峒
津	津	津
洪	洪,洚	洪,洚
洫	洫	洫
洲	洲	洲
洳	洳	洳
洵	洵	洵
活	活	活
洽	洽	洽
派	派	派
流	流	流
浙	浙	浙
浚	浚,濬	浚
浣	浣,澣	浣
浦	浦	浦
浩	浩,澔	浩
浪	浪	浪
浮	浮	浮
浴	浴	浴
海	海	海
浸	浸	浸
涅	涅	涅
消	消	消
涌	涌,湧	涌
涎	涎	涎
涓	涓	涓
涕	涕,洟	涕
涯	涯	涯
液	液	液
涵	涵	涵
涸	涸,凅	涸
淀	淀,澱	淀
淅	淅	淅
淆	淆,殽,肴,餚	淆,肴
淇	淇	淇
淋	淋	淋
淌	淌	淌
淑	淑	淑
淘	淘	淘
淙	淙	淙
淞	淞	淞
淡	淡,澹	淡,澹
淤	淤	淤
淦	淦	淦
淫	淫,婬	淫
淬	淬	淬
淮	淮	淮
深	深	深
淳	淳	淳
混	混	混
淹	淹,渰	淹
添	添	添
清	清	清
渚	渚,陼	渚
渝	渝	渝
渠	渠	渠
渡	渡	渡
渣	渣	渣
渤	渤	渤
渥	渥	渥
渫	渫,泄,洩	渫,泄
渭	渭	渭
港	港	港
游	游,遊	游
渺	渺	渺
湃	湃	湃
湍	湍	湍
湎	湎	湎
湖	湖	湖
湘	湘	湘
湛	湛	湛
湟	湟,況	湟,况
湫	湫	湫
湮	湮	湮
溏	溏	溏
源	源	源
溘	溘	溘
溜	溜,霤	溜
溟	溟	溟
溢	溢	溢
溥	溥	溥
溪	溪,谿	溪
溯	溯,泝	溯
溲	溲	溲
溶	溶	溶
溷	溷	溷
溺	溺,尿	溺,尿
溽	溽,縟	溽,缛
滂	滂	滂
滋	滋	滋
滑	滑	滑
滓	滓	滓
滔	滔	滔
滕	滕	滕
滴	滴	滴
漂	漂	漂
漆	漆,柒,桼	漆,柒
漉	漉	漉
漏	漏	漏
漓	漓,灕,巑	漓
演	演,縯	演
漕	漕	漕
漠	漠	漠
漫	漫	漫
漱	漱	漱
漾	漾,瀁	漾
潘	潘	潘
潦	潦,澇	潦,涝
潭	潭	潭
潮	潮	潮
潸	潸	潸
潺	潺	潺
潼	潼	潼
澄	澄,澂	澄
澎	澎	澎
澡	澡	澡
澳	澳,襖	澳,袄
澹	澹,淡	澹,淡
激	激	激
濂	濂	濂
濠	濠	濠
濡	濡	濡
濮	濮	濮
濯	濯	濯
瀑	瀑	瀑
瀚	瀚	瀚
瀛	瀛	瀛
灌	灌	灌
火	火	火,灬
灰	灰	灰
灸	灸	灸
灼	灼	灼
炊	炊	炊
炎	炎	炎
炒	炒	炒
炙	炙	炙
炬	炬	炬
炭	炭	炭
炮	炮,砲,炰	炮
炯	炯	炯
炳	炳	炳
炸	炸,煠	炸
烈	烈	烈
烙	烙	烙
烹	烹	烹
烽	烽	烽
焉	焉	焉
焙	焙	焙
焚	焚	焚
焦	焦	焦
然	然	然
煌	煌	煌
煎	煎	煎
煤	煤	煤
煦	煦	煦
照	照,炤	照
煮	煮	煮
煽	煽,搧	煽
熄	熄	熄
熊	熊	熊
熏	熏,燻	熏
熔	熔,鎔	熔
熙	熙	熙
熟	熟	熟
熨	熨,尉,燙	熨,尉
熬	熬	熬
熹	熹	熹
燃	燃	燃
燎	燎	燎
燔	燔	燔
燕	燕,鷰	燕
燠	燠	燠
燥	燥	燥
燧	燧	燧
燮	燮	燮
燹	燹	燹
爆	爆	爆
爨	爨	爨
爪	爪	爪
爬	爬	爬
爰	爰	爰
爵	爵	爵
父	父	父
爻	爻	爻
爽	爽	爽
爿	爿	爿,丬
片	片	片
版	版,板,闆	版,板
牌	牌	牌
牒	牒	牒
牙	牙	牙
牛	牛	牛
牝	牝	牝
牟	牟,麰	牟
牡	牡	牡
牢	牢	牢
牧	牧	牧
物	物	物
牲	牲	牲
特	特	特
牾	牾	牾
犀	犀	犀
犁	犁,犛	犁
犒	犒	犒
犬	犬	犬,犭
犯	犯	犯
狂	狂	狂
狃	狃	狃
狄	狄	狄
狎	狎	狎
狐	狐	狐
狒	狒	狒
狗	狗	狗
狙	狙	狙
狠	狠	狠
狡	狡	狡
狩	狩	狩
狷	狷,獧	狷
狸	狸,貍	狸
狼	狼	狼
猊	猊	猊
猖	猖	猖
猗	猗,欹	猗,欹
猛	猛	猛
猜	猜	猜
猝	猝	猝
猥	猥	猥
猩	猩	猩
猴	猴	猴
猷	猷	猷
猾	猾,獪	猾,狯
猿	猿,蝯	猿
獗	獗	獗
玄	玄,伭	玄
率	率	率
玉	玉,玊	玉
王	王	王
玖	玖,九	玖,九
玩	玩	玩
玲	玲	玲
玳	玳	玳
玻	玻	玻
珀	珀	珀
珂	珂	珂
珈	珈	珈
珊	珊	珊
珍	珍	珍
珞	珞	珞
珠	珠	珠
珥	珥	珥
班	班	班
球	球,毬	球
琅	琅,瑯	琅
理	理	理
琉	琉	琉
琢	琢	琢
琥	琥	琥
琳	琳	琳
琴	琴	琴
琵	琵	琵
琶	琶	琶
瑁	瑁	瑁
瑕	瑕	瑕
瑙	瑙	瑙
瑚	瑚	瑚
瑛	瑛	瑛
瑜	瑜	瑜
瑞	瑞	瑞
瑟	瑟	瑟
瑰	瑰	瑰
瑾	瑾	瑾
璃	璃	璃
璋	璋	璋
璞	璞	璞
璧	璧	璧
瓜	瓜	瓜
瓠	瓠	瓠
瓢	瓢	瓢
瓣	瓣,弁	瓣,弁
瓦	瓦	瓦
瓮	瓮,甕,罋	瓮
瓶	瓶,缾	瓶
瓷	瓷,磁	瓷,磁
甄	甄	甄
甍	甍	甍
甑	甑	甑
甓	甓	甓
甘	甘	甘
甚	甚,什	甚,什
甜	甜	甜
生	生	生
甥	甥	甥
用	用	用
甫	甫	甫
甬	甬,埇	甬
田	田	田
由	由	由
甲	甲	甲
申	申	申
男	男	男
甸	甸	甸
町	町,圢	町
畋	畋	畋
界	界	界
畏	畏	畏
畔	畔	畔
留	留	留
畚	畚	畚
畛	畛	畛
畜	畜	畜
略	略	略
畦	畦	畦
番	番,蹯	番,蹯
畸	畸	畸
畿	畿	畿
疆	疆,將	疆,将
疋	疋,匹	疋,匹
疏	疏	疏
疑	疑	疑
疔	疔	疔
疚	疚	疚
疝	疝	疝
疣	疣	疣
疥	疥	疥
疫	疫	疫
疲	疲	疲
疳	疳	疳
疵	疵	疵
疸	疸,癉	疸,瘅
疹	疹,胗	疹,胗
疼	疼	疼
疽	疽	疽
疾	疾	疾
痂	痂	痂
病	病	病
症	症,癥	症
痊	痊	痊
痍	痍	痍
痒	痒,癢	痒
痔	痔	痔
痕	痕	痕
痘	痘	痘
痛	痛	痛
痞	痞	痞
痢	痢	痢
痣	痣	痣
痰	痰	痰
痴	痴,癡	痴
痼	痼	痼
痿	痿	痿
瘁	瘁	瘁
瘟	瘟	瘟
瘠	瘠	瘠
瘢	瘢	瘢
瘤	瘤	瘤
瘰	瘰	瘰
瘴	瘴	瘴
癌	癌	癌
癖	癖	癖
癜	癜	癜
癸	癸	癸
登	登,豋	登
白	白	白
百	百,佰	百,佰
的	的	的
皆	皆	皆
皇	皇	皇
皈	皈,歸	皈,归
皋	皋,睾,睪	皋,睾
皎	皎,皦	皎
皓	皓,顥,皝	皓,颢
皖	皖	皖
皙	皙	皙
皮	皮	皮
皴	皴	皴
皿	皿	皿
盂	盂	盂
盆	盆	盆
盈	盈	盈
益	益	益
盍	盍	盍
盒	盒	盒
盛	盛	盛
盟	盟	盟
盥	盥	盥
目	目	目
盲	盲	盲
直	直	直
相	相	相
盾	盾	盾
省	省	省
眄	眄	眄
眇	眇,緲	眇,缈
眈	眈	眈
眉	眉	眉
看	看	看
真	真	真
眠	眠,緡	眠,缗
眩	眩	眩
眷	眷	眷
眸	眸	眸
眺	眺	眺
眼	眼	眼
睇	睇	睇
睚	睚	睚
睛	睛	睛
睡	睡	睡
督	督	督
睥	睥	睥
睦	睦	睦
睨	睨	睨
睫	睫	睫
睹	睹	睹
睾	睾,睪,皋	睾,皋
睿	睿,叡	睿
瞎	瞎	瞎
瞑	瞑	瞑
瞠	瞠,瞪	瞠,瞪
瞥	瞥,苤	瞥,苤
瞬	瞬	瞬
瞰	瞰,矙	瞰
瞳	瞳	瞳
瞻	瞻	瞻
瞽	瞽	瞽
瞿	瞿	瞿
矍	矍	矍
矗	矗	矗
矛	矛	矛
矜	矜	矜
矢	矢	矢
矣	矣	矣
知	知	知
矧	矧	矧
矩	矩	矩,榘
短	短	短
矮	矮	矮
石	石	石
砂	砂	砂
砌	砌,纖,縴	砌,纤
砒	砒	砒
研	研,硎,揅	研,硎
砥	砥,厎	砥
砦	砦,寨	砦,寨
砧	砧,碪	砧
破	破	破
硅	硅,矽	硅,矽
硝	硝	硝
硫	硫	硫
硬	硬,應	硬,应
硼	硼	硼
碇	碇	碇
碌	碌	碌
碎	碎	碎
碑	碑	碑
碓	碓	碓
碗	碗	碗
碚	碚	碚
碣	碣	碣
碧	碧	碧
碾	碾	碾
磁	磁,瓷	磁,瓷
磅	磅	磅
磊	磊,磥	磊
磋	磋	磋
磐	磐	磐
磔	磔	磔
磨	磨	磨
磬	磬	磬
磴	磴,嶝	磴,嶝
礁	礁	礁
示	示	示,礻
社	社	社
祀	祀	祀
祁	祁	祁
祈	祈	祈
祉	祉	祉
祓	祓	祓
祖	祖	祖
祗	祗,只,衹,隻,祇	祗,只
祚	祚	祚
祝	祝	祝
神	神	神
祟	祟	祟
祠	祠	祠
祥	祥	祥
票	票	票
祭	祭	祭
祺	祺	祺
禁	禁	禁
禊	禊	禊
福	福	福
禧	禧	禧
禳	禳	禳
禹	禹	禹
禺	禺	禺
禽	禽	禽
禾	禾	禾
秀	秀	秀
私	私	私,厶
秉	秉,拼	秉,拼
秋	秋,鞦	秋
科	科	科
秒	秒	秒
秕	秕	秕
秘	秘,祕	秘
租	租	租
秣	秣	秣
秤	秤,稱	秤,称
秦	秦	秦
秧	秧	秧
秩	秩	秩
移	移,迻	移
稀	稀,希	稀,希
程	程	程
稍	稍	稍
稔	稔	稔
稗	稗	稗
稚	稚	稚
稠	稠	稠
稷	稷	稷
稻	稻	稻
稼	稼	稼
稽	稽,乩	稽,乩
稿	稿	稿,藁
穆	穆	穆
穗	穗	穗
穰	穰	穰
穴	穴	穴
究	究	究
穹	穹	穹
空	空	空
穿	穿	穿
突	突	突
窄	窄	窄
窈	窈	窈
窒	窒	窒
窕	窕,阿	窕,阿
窖	窖,窌	窖
窗	窗	窗
窘	窘	窘
窟	窟	窟
窿	窿	窿
立	立	立
站	站	站
竟	竟	竟
章	章	章
竣	竣	竣
童	童	童
竦	竦	竦
竭	竭	竭
端	端,耑	端
竹	竹	竹
竺	竺	竺
竿	竿	竿
笄	笄	笄
笆	笆,巴	笆,巴
笈	笈	笈
笊	笊	笊
笏	笏	笏
笑	笑	笑
笙	笙	笙
笛	笛,篴	笛
笞	笞	笞
笠	笠	笠
笥	笥	笥
符	符	符
笨	笨	笨
第	第	第
笳	笳	笳
筅	筅	筅
等	等	等
筋	筋,觔	筋
筌	筌	筌
筏	筏	筏
筐	筐	筐
筑	筑,築	筑
筒	筒	筒
答	答,荅	答
策	策	策
筮	筮	筮
筱	筱,篠	筱
筵	筵	筵
箍	箍,箛	箍
箔	箔,泡	箔,泡
箕	箕	箕
算	算,筭	算
箜	箜	箜
箝	箝,鉗	箝,钳
管	管,筦	管
箭	箭	箭
箱	箱	箱
箴	箴,針,鍼	箴,针
箸	箸	箸
篁	篁	篁
篆	篆	篆
篇	篇	篇
篌	篌	篌
篝	篝	篝
篥	篥	篥
篦	篦,笓	篦
篷	篷	篷
簇	簇	簇
簟	簟	簟
簧	簧	簧
簪	簪	簪
簸	簸	簸
簿	簿	簿
籀	籀	籀
籍	籍	籍
米	米	米
粉	粉	粉
粒	粒	粒
粕	粕	粕
粗	粗,麤,觕	粗
粘	粘,黏	粘,黏
粟	粟	粟
粢	粢	粢
粥	粥,鬻	粥,鬻
粱	粱	粱
粲	粲	粲
粳	粳	粳
粹	粹	粹
粽	粽	粽
精	精	精
糅	糅	糅
糊	糊,胡,衚,鬍	糊,胡
糖	糖	糖
糜	糜	糜
糟	糟,蹧	糟
糠	糠	糠
糯	糯	糯
糸	糸,絲	糸,丝
系	系,係,繫	系
紊	紊	紊
素	素	素
索	索	索
紫	紫	紫
累	累,纍	累
絮	絮	絮
綮	綮	綮
縻	縻	縻
繁	繁	繁
纂	纂,臇	纂
纛	纛	纛
缶	缶,罐	缶,罐
缸	缸,堈	缸
缺	缺,欠	缺,欠
罅	罅	罅
罐	罐,缶	罐,缶
网	网,網,罔	网,罔
罔	罔,网,網	罔,网
罕	罕	罕
罘	罘,罦	罘
罟	罟	罟
罨	罨	罨
罩	罩	罩
罪	罪	罪
置	置,寘	置
署	署,穎	署,颖
罹	罹	罹
羊	羊	羊
羌	羌	羌
美	美	美
羔	羔	羔
羚	羚	羚
羝	羝,牴	羝
羞	羞	羞
群	群	群
羯	羯	羯
羲	羲	羲
羸	羸	羸
羹	羹	羹
羽	羽	羽
翁	翁	翁
翅	翅	翅
翊	翊	翊
翌	翌	翌
翔	翔	翔
翕	翕	翕
翠	翠	翠
翡	翡	翡
翦	翦,剪	翦,剪
翩	翩	翩
翰	翰	翰
翳	翳,影	翳,影
翻	翻,繙	翻
翼	翼,折	翼,折
耀	耀,曜,燿	耀,曜
老	老	老
考	考,攷	考
耄	耄	耄
者	者	者
耆	耆	耆
耋	耋	耋
而	而	而
耐	耐,耏	耐
耒	耒,來	耒,来
耕	耕,簡	耕,简
耗	耗,秏	耗
耘	耘	耘
耙	耙,鈀	耙,钯
耜	耜	耜
耨	耨,鎒	耨
耳	耳	耳
耶	耶	耶
耽	耽	耽
耿	耿,炅	耿,炅
聆	聆	聆
聊	聊	聊
聒	聒	聒
聘	聘	聘
聚	聚	聚
聿	聿	聿,肀
肄	肄	肄
肆	肆,四	肆,四
肇	肇	肇
肉	肉	肉
肋	肋	肋
肌	肌	肌
肓	肓	肓
肖	肖	肖
肘	肘	肘
肚	肚	肚
肛	肛	肛
肝	肝	肝
股	股	股
肢	肢,胑	肢
肥	肥	肥
肩	肩	肩
肪	肪	肪
肭	肭	肭
肯	肯	肯
肱	肱	肱
育	育,毓	育,毓
肴	肴,餚,殽	肴
肺	肺	肺
胃	胃	胃
胄	胄,冑	胄
背	背,揹,絣	背
胎	胎	胎
胖	胖	胖
胙	胙	胙
胚	胚	胚
胛	胛	胛
胝	胝,郅	胝,郅
胞	胞,脬	胞,脬
胡	胡,衚,鬍,楜	胡
胤	胤	胤
胥	胥	胥
胯	胯,骻	胯
胱	胱	胱
胴	胴	胴
胸	胸,匈	胸,匈
胼	胼	胼
能	能	能
脂	脂	脂
脆	脆	脆
脊	脊	脊
脯	脯	脯
脾	脾	脾
腆	腆	腆
腋	腋	腋
腐	腐	腐
腑	腑	腑
腓	腓	腓
腔	腔	腔
腕	腕	腕
腥	腥	腥
腮	腮,鰓	腮,鳃
腰	腰	腰
腱	腱	腱
腴	腴	腴
腹	腹	腹
腺	腺	腺
腿	腿	腿
膀	膀	膀
膂	膂	膂
膈	膈	膈
膊	膊	膊
膏	膏	膏
膜	膜	膜
膝	膝	膝
膣	膣	膣
膨	膨	膨
膳	膳	膳
膺	膺	膺
臀	臀	臀
臂	臂	臂
臆	臆	臆
臣	臣	臣
臧	臧	臧
自	自	自
臭	臭	臭
至	至	至
致	致,緻	致
臻	臻	臻
臼	臼	臼
臾	臾	臾
舁	舁	舁
舂	舂	舂
舅	舅	舅
舌	舌	舌
舍	舍,捨	舍
舐	舐	舐
舒	舒,摴	舒
舛	舛	舛
舜	舜	舜
舞	舞	舞
舟	舟	舟
航	航,桁	航,桁
舫	舫	舫
般	般	般
舳	舳	舳
舵	舵,柁	舵,柁
舶	舶	舶
舷	舷	舷
舸	舸	舸
船	船,舡	船,舡
艇	艇	艇
艘	艘	艘
艚	艚	艚
艟	艟	艟
艨	艨	艨
艮	艮	艮
良	良	良
色	色	色
艾	艾	艾
芋	芋	芋
芍	芍	芍
芒	芒	芒
芙	芙	芙
芝	芝	芝
芟	芟	芟
芥	芥	芥
芫	芫	芫
芬	芬	芬
芭	芭,巴	芭,巴
芯	芯	芯
花	花,蘤	花
芳	芳	芳
芸	芸,蕓,藝	芸,艺
芹	芹	芹
芽	芽	芽
苑	苑,菀	苑,菀
苒	苒	苒
苓	苓	苓
苔	苔,薹	苔,薹
苗	苗	苗
苛	苛,哼	苛,哼
苜	苜	苜
苞	苞	苞
苟	苟,茍	苟
苡	苡	苡
苣	苣	苣
若	若	若
苦	苦	苦
苫	苫	苫
英	英,偀	英
苴	苴	苴
苹	苹,蘋	苹
苻	苻	苻
茂	茂,楙	茂
范	范,範	范
茄	茄	茄
茅	茅,泖	茅,泖
茆	茆,茅	茆,茅
茉	茉	茉
茗	茗	茗
茜	茜,芊	茜,芊
茨	茨	茨
茫	茫	茫
茯	茯	茯
茱	茱	茱
茴	茴	茴
茵	茵	茵
茶	茶	茶
茸	茸	茸
茹	茹	茹
荀	荀	荀
草	草,艸	草,艹
荏	荏	荏
荐	荐,薦	荐
荒	荒	荒
荷	荷	荷
荻	荻	荻
荼	荼	荼
莉	莉	莉
莎	莎	莎
莓	莓,苺	莓
莞	莞	莞
莠	莠	莠
莨	莨	莨
莪	莪	莪
莫	莫	莫
莽	莽	莽
菁	菁	菁
菅	菅	菅
菊	菊	菊
菌	菌,蕈,滾	菌,蕈,滚
菖	菖	菖
菘	菘	菘
菜	菜	菜
菟	菟,兔	菟,兔
菠	菠	菠
菩	菩	菩
菰	菰,菇	菰,菇
菱	菱,蔆	菱
菲	菲	菲
菽	菽	菽
萃	萃	萃
萄	萄	萄
萋	萋	萋
萌	萌	萌
萍	萍	萍
萎	萎,荽	萎,荽
萱	萱,萲	萱
萸	萸	萸
萼	萼	萼
落	落	落
葆	葆	葆
著	著,螫	著,着,螫
葛	葛	葛
葡	葡	葡
董	董	董
葩	葩	葩
葫	葫,胡,衚,鬍	葫,胡
葬	葬	葬
葭	葭	葭
葵	葵	葵
葺	葺	葺
蒂	蒂,蔕	蒂
蒙	蒙,濛,矇,懞	蒙
蒜	蒜	蒜
蒡	蒡	蒡
蒲	蒲,莆	蒲,莆
蒸	蒸,烝	蒸
蒹	蒹	蒹
蒿	蒿	蒿
蓁	蓁	蓁
蓄	蓄	蓄
蓉	蓉	蓉
蓊	蓊	蓊
蓍	蓍	蓍
蓐	蓐	蓐
蓑	蓑,簑	蓑
蓖	蓖,芘,萆	蓖,芘,萆
蓬	蓬	蓬
蓼	蓼	蓼
蓿	蓿	蓿
蔑	蔑,衊	蔑
蔓	蔓	蔓
蔗	蔗,本	蔗,本
蔚	蔚	蔚
蔟	蔟	蔟
蔡	蔡	蔡
蔬	蔬	蔬
蔽	蔽,芘	蔽,芘
蕃	蕃	蕃
蕈	蕈,菌	蕈,菌
蕉	蕉	蕉
蕊	蕊	蕊
蕨	蕨	蕨
蕾	蕾	蕾
薄	薄	薄
薇	薇	薇
薛	薛	薛
薜	薜	薜
薤	薤	薤
薨	薨	薨
薪	薪	薪
薯	薯,藷	薯
薹	薹,苔	薹,苔
藉	藉,借,耤	藉,借
藏	藏	藏
藐	藐	藐
藕	藕	藕
藜	藜	藜
藤	藤,籐	藤
藩	藩	藩
藻	藻	藻
虍	虍	虍
虎	虎	虎
虐	虐,乇	虐,乇
虔	虔	虔
虞	虞	虞
虫	虫,蟲	虫
虱	虱,蝨	虱
虹	虹	虹
虻	虻	虻
蚊	蚊	蚊
蚋	蚋	蚋
蚌	蚌	蚌
蚓	蚓,螾	蚓
蚕	蚕,蠶	蚕
蚣	蚣	蚣
蚤	蚤	蚤
蚩	蚩	蚩
蚪	蚪,虯	蚪,虬
蚯	蚯	蚯
蚰	蚰	蚰
蚶	蚶	蚶
蛄	蛄,蛌	蛄
蛆	蛆	蛆
蛇	蛇	蛇
蛉	蛉	蛉
蛋	蛋,旦,蜑	蛋,旦
蛔	蛔,蚘	蛔
蛙	蛙	蛙
蛛	蛛	蛛
蛞	蛞	蛞
蛟	蛟	蛟
蛤	蛤	蛤
蛩	蛩	蛩
蛭	蛭	蛭
蛸	蛸	蛸
蛹	蛹	蛹
蛾	蛾	蛾
蜀	蜀	蜀
蜂	蜂	蜂
蜃	蜃	蜃
蜈	蜈	蜈
蜉	蜉	蜉
蜊	蜊	蜊
蜍	蜍,蠩	蜍
蜒	蜒	蜒
蜘	蜘	蜘
蜚	蜚	蜚
蜜	蜜	蜜
蜥	蜥	蜥
蜩	蜩	蜩
蜴	蜴	蜴
蜷	蜷,踡	蜷
蜻	蜻	蜻
蜿	蜿	蜿
蝌	蝌	蝌
蝎	蝎,蠍	蝎
蝓	蝓	蝓
蝗	蝗	蝗
蝙	蝙	蝙
蝠	蝠	蝠
蝣	蝣	蝣
蝮	蝮	蝮
蝴	蝴,胡,衚,鬍	蝴,胡
蝶	蝶,蜨	蝶
螂	螂,蜋	螂
融	融	融
螟	螟	螟
螫	螫,著	螫,著,着
螯	螯	螯
螳	螳,螗,蟷	螳,螗
螺	螺,蠃	螺,蠃
螽	螽	螽
蟀	蟀	蟀
蟆	蟆	蟆
蟋	蟋	蟋
蟒	蟒	蟒
蟠	蟠	蟠
蟹	蟹	蟹
蟾	蟾	蟾
蠕	蠕	蠕
蠖	蠖	蠖
蠡	蠡	蠡
蠢	蠢,惷	蠢
蠹	蠹	蠹
血	血	血
衄	衄	衄
行	行	行
衍	衍	衍
街	街,亍	街,亍
衙	衙	衙
衡	衡	衡
衢	衢	衢
衣	衣	衣,衤
表	表,錶	表
衫	衫	衫
衰	衰	衰
衲	衲	衲
衷	衷	衷
衽	衽	衽
衾	衾	衾
衿	衿,紟,襟	衿,襟
袁	袁	袁
袂	袂	袂
袈	袈	袈
袋	袋	袋
袍	袍	袍
袒	袒,襢	袒
袖	袖,褎	袖
袢	袢	袢
袤	袤	袤
被	被	被
袱	袱	袱
袷	袷,裌	袷
裁	裁	裁
裂	裂	裂
裔	裔	裔
裕	裕	裕
裘	裘	裘
裙	裙	裙
裟	裟	裟
裨	裨	裨
裳	裳	裳
裴	裴	裴
裸	裸	裸
裹	裹	裹
裼	裼	裼
裾	裾	裾
褂	褂	褂
褊	褊	褊
褐	褐	褐
褒	褒	褒
褓	褓,襤	褓,褴
褥	褥	褥
褪	褪	褪
褫	褫	褫
褶	褶	褶
襁	襁,繈	襁
襄	襄	襄
襞	襞	襞
襟	襟,衿	襟,衿
襦	襦	襦
西	西	西
要	要	要
覃	覃	覃
覆	覆,復,复,複	覆,复
角	角,甪	角
觚	觚	觚
觜	觜,咀,嘴	觜,咀,嘴
解	解	解
触	触,觸	触
言	言	言
詈	詈	詈
誓	誓	誓
謇	謇	謇
謦	謦	謦
警	警,儆	警,儆
譬	譬	譬
谷	谷,穀	谷
豁	豁	豁
豆	豆,荳	豆
豌	豌	豌
豕	豕	豕
豚	豚	豚
象	象,像	象,像
豢	豢	豢
豪	豪	豪
豫	豫,予,預	豫,予,预
豸	豸,廌	豸
豹	豹	豹
豺	豺	豺
貂	貂	貂
貅	貅	貅
貉	貉	貉
貊	貊,貘	貊,貘
貌	貌	貌
貔	貔	貔
貘	貘,貊	貘,貊
赤	赤	赤
赦	赦	赦
赧	赧	赧
赫	赫	赫
赭	赭	赭
走	走	走
赳	赳	赳
赴	赴	赴
起	起	起
趁	趁	趁
超	超	超
越	越	越
趣	趣	趣
足	足	足
趺	趺	趺
趾	趾	趾
跋	跋	跋
跌	跌	跌
跏	跏	跏
跖	跖,蹠	跖
跚	跚	跚
跛	跛	跛
距	距	距
跟	跟	跟
跣	跣	跣
跨	跨	跨
跪	跪	跪
跫	跫	跫
路	路	路
跳	跳,趒	跳
踉	踉	踉
踊	踊,踴	踊
踏	踏,蹋	踏,蹋
踝	踝	踝
踞	踞	踞
踟	踟	踟
踵	踵	踵
蹂	蹂	蹂
蹄	蹄	蹄
蹇	蹇	蹇
蹈	蹈	蹈
蹉	蹉	蹉
蹊	蹊	蹊
蹙	蹙	蹙
蹲	蹲	蹲
蹴	蹴	蹴
蹶	蹶	蹶
蹼	蹼	蹼
躁	躁,趮	躁
躅	躅	躅
躇	躇	躇
躔	躔	躔
身	身	身
躬	躬	躬
辛	辛	辛
辜	辜	辜
辟	辟,闢,避	辟,避
辣	辣	辣
辨	辨,弁,瓣,辦,辯,辮	辨,弁,辩,瓣,办,辫
辰	辰	辰
辱	辱	辱
迂	迂,遇	迂,遇
迄	迄	迄
迅	迅	迅
迎	迎	迎
近	近	近
返	返	返
迢	迢,岧	迢
迥	迥	迥
迦	迦	迦
迪	迪	迪
迫	迫	迫
迭	迭,疊	迭,叠
述	述	述
迷	迷	迷
迸	迸	迸
追	追	追
退	退	退
送	送	送
逃	逃	逃
逅	逅,遘	逅,遘
逆	逆	逆
逋	逋	逋
逍	逍	逍
透	透	透
逐	逐	逐
逑	逑	逑
途	途	途
逖	逖	逖
逗	逗	逗
通	通	通
逝	逝	逝
逞	逞,期	逞,期
速	速,跡,蹟	速,迹
造	造	造
逡	逡	逡
逢	逢	逢
逮	逮,迨	逮,迨
逵	逵	逵
逶	逶	逶
逸	逸	逸
逼	逼,偪	逼
逾	逾,踰	逾
遁	遁	遁
遂	遂	遂
遇	遇,迂	遇,迂
遍	遍	遍
遏	遏	遏
遐	遐	遐
遑	遑,徨	遑,徨
遒	遒	遒
道	道	道
遘	遘,逅	遘,逅
遣	遣	遣
遨	遨	遨
遭	遭,蹧,糟	遭,糟
遮	遮	遮
遵	遵	遵
遽	遽	遽
避	避,辟,闢	避,辟
邀	邀	邀
邂	邂	邂
邃	邃	邃
邑	邑	邑,阝
那	那	那
邦	邦	邦
邪	邪	邪
邯	邯	邯
邱	邱	邱
邵	邵	邵
邸	邸	邸
郁	郁,鬱	郁
郊	郊	郊
郎	郎	郎
郛	郛	郛
郡	郡	郡
郢	郢	郢
部	部	部,卩
郭	郭	郭
都	都	都
鄂	鄂	鄂
鄙	鄙	鄙
酉	酉,酋	酉,酋
酊	酊	酊
酋	酋,酉	酋,酉
酌	酌	酌
配	配	配
酎	酎	酎
酒	酒	酒
酢	酢,醋,榨	酢,醋,榨
酣	酣	酣
酥	酥	酥
酩	酩	酩
酪	酪	酪
酬	酬	酬
酲	酲	酲
酵	酵	酵
酷	酷	酷
酸	酸,痠	酸
醇	醇	醇
醉	醉	醉
醋	醋,酢	醋,酢
醍	醍	醍
醐	醐	醐
醒	醒,惺	醒,惺
醢	醢	醢
醪	醪	醪
醯	醯	醯
醴	醴	醴
醵	醵	醵
醺	醺	醺
采	采,埰,採,釆	采
釉	釉	釉
里	里,裡	里
重	重	重
野	野,埜	野
量	量	量
金	金	金,钅
釜	釜	釜
鏖	鏖	鏖
阜	阜	阜,阝
阡	阡,仟	阡,仟
阪	阪	阪,坂
阮	阮	阮
防	防	防
阻	阻	阻
阿	阿,啊	阿,啊
陀	陀	陀
陂	陂,坡	陂,坡
附	附	附
陋	陋	陋
陌	陌	陌
降	降	降
限	限	限
陛	陛	陛
陟	陟	陟
院	院	院
除	除	除
陪	陪	陪
陬	陬	陬
陲	陲	陲
陵	陵	陵
陶	陶,匋	陶
陷	陷	陷
隅	隅	隅
隆	隆	隆
隈	隈,渨,偎	隈,偎
隋	隋,陏	隋
隍	隍,堭	隍
隔	隔	隔
隗	隗	隗
隘	隘	隘
隙	隙	隙,郄
障	障	障
隧	隧	隧
隰	隰	隰
隹	隹	隹
隼	隼,鵻	隼
雀	雀	雀
雁	雁,鴈	雁
雄	雄	雄
雅	雅	雅
集	集	集
雇	雇,僱	雇
雉	雉	雉
雌	雌	雌
雍	雍,邕	雍,邕
雎	雎	雎
雕	雕,彫,鵰,凋,琱	雕,凋
雨	雨,馭	雨,驭
雪	雪	雪
零	零	零
雷	雷	雷
雹	雹	雹
需	需	需
霄	霄	霄
霆	霆	霆
震	震	震
霈	霈	霈
霍	霍	霍
霎	霎	霎
霏	霏	霏
霓	霓,蜺	霓
霖	霖	霖
霜	霜,孀	霜,孀
霞	霞	霞
霪	霪	霪
霰	霰	霰
露	露	露
霸	霸	霸
霹	霹	霹
霾	霾	霾
青	青	青
靖	靖	靖
非	非	非
靠	靠	靠
靡	靡	靡
面	面,麵	面
革	革	革
靴	靴	靴
靼	靼	靼
鞅	鞅	鞅
鞋	鞋	鞋
鞍	鞍	鞍
鞘	鞘	鞘
鞠	鞠	鞠
鞣	鞣	鞣
鞫	鞫	鞫
鞭	鞭	鞭
韭	韭,艽	韭,艽
音	音	音
韶	韶	韶
食	食	食,饣
餐	餐	餐
餮	餮	餮
饕	饕,叨	饕,叨
首	首	首
馗	馗	馗
馘	馘,聝	馘
香	香	香
馥	馥	馥
馨	馨	馨
骨	骨	骨
骰	骰	骰
骸	骸	骸
骼	骼	骼
髀	髀	髀
髑	髑	髑
髓	髓	髓
高	高	高
髟	髟	髟
髦	髦,犛	髦
髫	髫	髫
髭	髭	髭
髯	髯	髯
髻	髻	髻
鬟	鬟	鬟
鬣	鬣	鬣
鬯	鬯	鬯
鬲	鬲	鬲
鬻	鬻,粥	鬻,粥
鬼	鬼	鬼
魁	魁	魁
魂	魂	魂
魃	魃	魃
魄	魄	魄
魅	魅	魅
魍	魍	魍
魏	魏,巍	魏,巍
魑	魑	魑
魔	魔	魔
鹿	鹿	鹿
麈	麈	麈
麋	麋	麋
麒	麒	麒
麓	麓	麓
麝	麝	麝
麟	麟	麟
麻	麻,菻,痲	麻
麾	麾	麾
黍	黍	黍
黎	黎	黎
黏	黏,粘	黏,粘
黔	黔	黔
默	默,嘿	默,嘿
黛	黛	黛
黜	黜	黜
黝	黝	黝
黠	黠	黠
黥	黥	黥
黯	黯	黯
黹	黹	黹
黻	黻	黻
黼	黼	黼
鼎	鼎	鼎
鼓	鼓	鼓
鼠	鼠	鼠
鼬	鼬	鼬
鼻	鼻	鼻
鼾	鼾	鼾
龠	龠,籥	龠
並	並,并,併	并
丼	丼,井	井
亂	亂	乱
亙	亙	亘
亞	亞	亚
伝	伝,傳	传
佇	佇	伫
併	併,並,并	并
來	來,耒,徠	来,耒,徕
侖	侖,崙	仑
侶	侶	侣
係	係,系,繫	系
倆	倆	俩
倉	倉	仓
個	個,箇	个
們	們	们
倖	倖,幸,囟,曰	幸,囟,曰
倣	倣,仿,彷	仿,彷
倫	倫	伦
偉	偉	伟
側	側	侧
偵	偵	侦
偽	偽	伪
傑	傑,杰	杰
傘	傘,繖	伞
備	備	备
傚	傚,效	效
傭	傭,佣	佣
傳	傳,伝	传
傴	傴	伛
債	債	债
傷	傷	伤
傾	傾	倾
僂	僂	偻
僅	僅	仅
僉	僉	佥
僊	僊,仙	仙
僑	僑	侨
僕	僕,仆	仆
僣	僣,僭	僭
僥	僥	侥
價	價,价	价
儀	儀	仪
儂	儂	侬
億	億	亿
儉	儉	俭
儔	儔	俦
儕	儕	侪
儘	儘,盡	尽
償	償	偿
優	優,优	优
儲	儲	储
儷	儷	俪
儺	儺	傩
儻	儻,倘	傥,倘
儼	儼	俨
兇	兇,凶	凶
兌	兌	兑
兒	兒,儿	儿
兩	兩	两
冊	冊	册
冑	冑,胄	胄
冪	冪,羃,鼏	幂
凅	凅,涸	涸
凍	凍	冻
凜	凜	凛
凱	凱	凯
別	別	别
刪	刪	删
剄	剄	刭
則	則	则
剋	剋,克	克
剛	剛	刚
剴	剴	剀
創	創,刱,戧	创,戗
劃	劃,划,畫	划,画
劇	劇	剧
劉	劉	刘
劍	劍	剑
劑	劑	剂
勁	勁,俓	劲
動	動	动
勗	勗,勖	勖
務	務	务
勝	勝,胜	胜
勞	勞	劳
勢	勢	势
勣	勣,績	绩,积
勦	勦,剿	剿
勳	勳,勛	勋
勵	勵,勱	励,劢
勸	勸	劝
匯	匯,彙	汇
匱	匱,樻,鐀,櫃,饋,柜	匮,柜,馈
區	區	区
卍	卍,万,萬	万
協	協,勰	协,勰
卻	卻	却
厖	厖,龐,庬	庞
厭	厭	厌
參	參	参
叡	叡,睿	睿
叢	叢	丛
吋	吋,寸	寸
吶	吶,訥	呐,讷
呂	呂	吕
咥	咥,嘻	嘻
咼	咼	呙
員	員	员
唄	唄	呗
唸	唸,念	念
唹	唹,唷	唷
問	問	问
啗	啗,啖,噉	啖
啣	啣,銜	衔
喚	喚	唤
喪	喪	丧
喫	喫,吃	吃
喬	喬	乔
單	單	单
嗇	嗇	啬
嗚	嗚	呜
嘆	嘆,歎	叹
嘔	嘔,慪	呕,怄
嘖	嘖	啧
嘗	嘗,嚐	尝
嘩	嘩,譁	哗
嘯	嘯	啸
嘸	嘸	呒
噴	噴,呠,歕	喷
噸	噸,吨	吨
嚀	嚀	咛
嚇	嚇	吓
嚥	嚥,咽	咽
嚮	嚮,向,曏	向
嚴	嚴	严
嚶	嚶	嘤
囀	囀	啭
囁	囁,讘	嗫
囂	囂	嚣
囈	囈	呓
囑	囑	嘱
囓	囓,嚙,齧	啮
囮	囮,諤	谔
國	國	国
圍	圍	围
園	園	园
圓	圓	圆
圖	圖	图
團	團,糰	团
埜	埜,野	野
執	執	执
埼	埼,崎,碕	崎
堅	堅	坚
堊	堊,聖,圣	垩,圣
堝	堝	埚
堯	堯	尧
報	報	报
場	場	场
塊	塊	块
塋	塋	茔
塒	塒	埘
塗	塗,涂	涂
塚	塚,中,冢	冢,中
塢	塢,鄔	坞,邬
塵	塵	尘
塹	塹	堑
墜	墜	坠
墫	墫,樽	樽
墮	墮	堕
墳	墳	坟
墾	墾	垦
壇	壇,罈	坛
壓	壓	压
壘	壘	垒
壙	壙	圹
壞	壞,坏	坏
壟	壟	垄
壯	壯	壮
壺	壺	壶
壽	壽	寿
夢	夢	梦
夾	夾	夹
奐	奐	奂
奧	奧	奥
奩	奩	奁
奪	奪	夺
奮	奮	奋
妝	妝	妆
姦	姦,奸	奸
姪	姪,侄	侄
婁	婁	娄
婦	婦	妇
婬	婬,淫	淫
媼	媼	媪
媽	媽	妈
嫗	嫗	妪
嫻	嫻	娴
嬋	嬋	婵
嬌	嬌,撟	娇,挢
嬪	嬪	嫔
嬰	嬰	婴
嬾	嬾,懶	懒
孃	孃,娘	娘
孫	孫	孙
學	學	学
宮	宮	宫
寔	寔,實	实
寢	寢	寝
實	實,寔	实
寧	寧,甯,寍,宁	宁,甯
審	審	审
寫	寫	写
寵	寵	宠
寶	寶	宝
將	將	将
專	專,耑	专
尋	尋	寻
對	對	对
導	導	导
尨	尨,龍	龙
屆	屆	届
屍	屍,尸	尸
層	層	层
屬	屬	属
岡	岡,崗,堽	冈,岗
島	島	岛
峽	峽	峡
崋	崋,華	华
崑	崑,昆	昆
崗	崗,岡,堽	岗,冈
崙	崙,侖	仑
崢	崢	峥
嵐	嵐	岚
嶄	嶄,巉	崭
嶇	嶇	岖
嶺	嶺,岭	岭
嶼	嶼	屿
嶽	嶽,岳	岳
巉	巉,嶄	崭
巒	巒	峦
巖	巖,岩,嵒,碞	岩
帥	帥	帅
師	師	师
帳	帳,賬	帐,账
帶	帶	带
幀	幀	帧
幃	幃	帏
幗	幗	帼
幟	幟	帜
幣	幣	币
幵	幵,開	开
幹	幹,干,乾,榦	干,乾
幾	幾,几	几
庫	庫	库
廁	廁	厕
廂	廂	厢
廈	廈	厦
廚	廚	厨
廝	廝	厮
廟	廟	庙
廠	廠,厂	厂
廡	廡	庑
廢	廢	废
廣	廣	广
廩	廩,稟	廪,禀
廬	廬	庐
廳	廳	厅
弔	弔,吊	吊
張	張	张
強	強,彊	强
彈	彈	弹
彊	彊,強	强
彌	彌,瀰	弥
彎	彎	弯
彙	彙,匯	汇
彫	彫,雕,鵰	雕
彿	彿,佛	佛
徑	徑,逕,俓,勁	径,迳,劲
從	從	从
徠	徠,來	徕,来
復	復,覆,复,複	复,覆
徹	徹,澈	彻,澈
恆	恆	恒
恟	恟,洶,忷	汹
恥	恥	耻
悵	悵	怅
悶	悶,懣	闷,懑
悽	悽,淒,凄	凄
惇	惇,敦	敦
惡	惡,噁	恶
惱	惱,嬲	恼,嬲
惷	惷,蠢	蠢
惻	惻	恻
愛	愛	爱
愨	愨	悫
愬	愬,訴	诉
愴	愴	怆
愾	愾	忾
慄	慄,栗	栗
態	態	态
慍	慍	愠
慘	慘	惨
慚	慚	惭
慟	慟	恸
慣	慣	惯
慫	慫	怂
慮	慮	虑
慳	慳	悭
慶	慶	庆
慾	慾,欲	欲
憂	憂,懮	忧
憊	憊	惫
憐	憐,怜	怜
憑	憑	凭
憚	憚	惮
憤	憤	愤
憫	憫,愍	悯,愍
憮	憮	怃
憲	憲	宪
憶	憶	忆
懃	懃,勤	勤
懇	懇	恳
應	應,硬	应,硬
懌	懌	怿
懍	懍	懔,檩
懣	懣,悶	懑,闷
懲	懲	惩
懶	懶,嬾	懒
懷	懷,怀,怌	怀
懸	懸	悬
懺	懺,忏	忏
懼	懼	惧
懽	懽,歡	欢
懾	懾	慑
戀	戀	恋
戉	戉,鉞	钺
戔	戔	戋
戰	戰	战
戲	戲	戏
扞	扞,捍	擀,捍
扠	扠,搋,叉	搋,叉
扱	扱,插	插
抃	抃,拚	拚
抔	抔,抱	抱
拏	拏,拿,挐	拿
挾	挾	挟
捨	捨,舍	舍
捫	捫	扪
捲	捲,卷	卷
掃	掃,埽	扫,埽
掛	掛,挂	挂
採	採,采,埰	采
揀	揀,柬	拣,柬
揚	揚	扬
換	換	换
揮	揮	挥
搆	搆,構,构	构
損	損	损
搖	搖	摇
搗	搗,擣	捣
搨	搨,搭	搭
搶	搶	抢
搾	搾,榨	榨
摯	摯	挚
摶	摶	抟
撈	撈	捞
撓	撓	挠
撚	撚,捻	捻
撥	撥	拨
撫	撫,拊	抚,拊
撲	撲,扑	扑,攴
撻	撻	挞
擁	擁	拥
擇	擇	择
擔	擔	担
據	據,据	据
擠	擠	挤
擣	擣,搗	捣
擬	擬,儗	拟
擯	擯	摈
擱	擱	搁
擲	擲,擿	掷
擴	擴	扩
擺	擺	摆
擾	擾,扰	扰
攜	攜	携
攝	攝	摄
攣	攣	挛
攤	攤	摊
攪	攪,搞	搅,搞
攬	攬	揽
攷	攷,考	考
敗	敗	败
敘	敘	叙
敵	敵	敌
數	數	数
斂	斂,歛	敛
斃	斃	毙
斬	斬	斩
斷	斷	断
旛	旛,幡	幡
昇	昇,升,陞	升
昜	昜,陽,暘	阳
時	時	时
晉	晉	晋
晝	晝	昼
晢	晢,晰	晰
暈	暈	晕
暉	暉	晖
暢	暢,昶	畅,昶
暫	暫	暂
暸	暸,瞭,了	了
曄	曄	晔
曇	曇	昙
曉	曉	晓
曖	曖	暧
曠	曠	旷
書	書	书
會	會	会
朧	朧,矓	胧
朮	朮,術	术
東	東	东
枴	枴,拐	拐
柆	柆,拉	拉
柵	柵	栅
桿	桿,杆	杆
梔	梔	栀
條	條,糶	条,粜
梟	梟,鴞	枭
棄	棄	弃
棗	棗	枣
棟	棟	栋
棧	棧	栈
棲	棲,栖	栖
椏	椏	桠
楊	楊	杨
楓	楓	枫
楙	楙,茂	茂
楜	楜,胡,衚,鬍	胡
業	業	业
極	極,极	极
榮	榮	荣
榿	榿	桤
槃	槃,盤	盘
構	構,搆,构	构
槍	槍,鎗	枪
槓	槓,杠,篢	杠
槧	槧	椠
槨	槨	椁
槻	槻,規	规
樂	樂	乐
樅	樅	枞
樓	樓	楼
標	標	标
樞	樞	枢
樣	樣	样
樸	樸,朴	朴
樹	樹	树
樺	樺	桦
橈	橈	桡
橋	橋	桥
機	機,机	机
橢	橢	椭
橦	橦,幢	幢
檜	檜,栝	桧,栝
檢	檢	检
檣	檣	樯
檳	檳	槟
檸	檸	柠
檻	檻	槛
櫂	櫂,棹,掉	棹,掉
櫃	櫃,匱,柜,樻,饋,鐀	柜,匮,馈
櫓	櫓	橹
櫚	櫚	榈
櫛	櫛	栉
櫞	櫞	橼
櫟	櫟	栎
櫨	櫨	栌
櫪	櫪	枥
櫺	櫺,欞	棂
櫻	櫻	樱
欄	欄	栏
權	權	权
欒	欒,灤	栾,滦
欖	欖	榄
欸	欸,唉	唉
欽	欽	钦
歎	歎,嘆	叹
歐	歐	欧
歛	歛,斂	敛
歟	歟	欤
歡	歡,驩,懽	欢
歸	歸,皈	归,皈
歿	歿	殁
殀	殀,夭	夭
殘	殘	残
殞	殞,隕	殒,陨
殤	殤	殇
殫	殫	殚
殯	殯	殡
殲	殲	歼
殺	殺	杀
殼	殼	壳
毀	毀,燬,譭	毁
毆	毆	殴
毘	毘,毗	毗
毬	毬,球	球
氈	氈	毡
氣	氣,气	气
氾	氾,泛,汎	泛
汎	汎,泛,氾	泛
決	決	决
沍	沍,冱	冱
沒	沒	没
沖	沖,盅,衝	冲,盅
況	況,湟	况,湟
泝	泝,溯	溯
洟	洟,涕	涕
洩	洩,泄,渫	泄,渫
洶	洶,忷,恟	汹
浹	浹	浃
涼	涼	凉
淒	淒,凄,悽	凄
淨	淨,凈	净
淪	淪	沦
淵	淵	渊
淺	淺	浅
渙	渙	涣
減	減	减
渦	渦	涡
測	測	测
渾	渾	浑
湊	湊	凑
湧	湧,涌	涌
湯	湯	汤
準	準,准,淮	准,淮
溝	溝	沟
滄	滄	沧
滅	滅	灭
滌	滌	涤
滬	滬	沪
滯	滯	滞
滲	滲	渗
滷	滷,鹵	卤
滸	滸	浒
滾	滾,菌	滚,菌
滿	滿	满
漁	漁	渔
漢	漢	汉
漣	漣	涟
漬	漬	渍
漲	漲	涨
漸	漸	渐
漿	漿	浆
潁	潁	颍
潔	潔,洁	洁
潛	潛	潜
潟	潟,瀉	泻
潤	潤	润
潯	潯	浔
潰	潰	溃
澀	澀,濇	涩
澂	澂,澄	澄
澆	澆	浇
澗	澗	涧
澣	澣,浣	浣
澤	澤	泽
澱	澱,淀	淀
濁	濁	浊
濃	濃	浓
濕	濕,溼	湿
濘	濘,泞	泞
濛	濛,霥,蒙,矇,懞	蒙
濟	濟	济
濤	濤	涛
濫	濫	滥
濬	濬,浚	浚
濱	濱,瀕	滨,浜,濒
濺	濺	溅
濾	濾	滤,沪
瀁	瀁,漾	漾
瀉	瀉	泻
瀋	瀋,沉,沈	沈,渖,沉
瀏	瀏	浏
瀕	瀕,濱	濒,滨
瀘	瀘	泸
瀝	瀝	沥
瀟	瀟	潇
瀦	瀦	潴
瀧	瀧	泷
瀰	瀰,彌	弥
瀲	瀲	潋
瀾	瀾	澜
灑	灑,洒	洒
灘	灘,潬	滩
灣	灣	湾
災	災,菑	灾
為	為	为
烏	烏	乌
烝	烝,蒸	蒸
無	無,橆	无
煉	煉,鍊	炼
煖	煖,暖,娠	暖,娠
煙	煙,完,菸	烟,完,菸
煢	煢	茕
煥	煥	焕
煩	煩	烦
煬	煬,烊	炀,烊
熱	熱	热
熾	熾	炽
燈	燈	灯
燉	燉,炖	炖
燒	燒,簫	烧,箫
營	營	营
燦	燦	灿
燬	燬,毀,譭	毁
燭	燭	烛
燻	燻,熏	熏
燼	燼	烬
燿	燿,曜,耀	曜,耀
爍	爍,鑠	烁,铄
爐	爐	炉
爛	爛	烂
爭	爭	争
爺	爺	爷
爾	爾,尒	尔
牆	牆,廧	墙
牋	牋,箋	笺
牘	牘	牍
牽	牽	牵
犖	犖	荦
犢	犢	犊
犧	犧	牺
狹	狹,陜	狭
狽	狽	狈
猶	猶	犹
獄	獄	狱
獅	獅	狮
獎	獎	奖
獨	獨	独
獪	獪,猾	狯,猾
獰	獰	狞
獲	獲,穫	获
獵	獵	猎
獸	獸	兽
獺	獺	獭
獻	獻	献
珪	珪,圭	圭
珮	珮,佩	佩
現	現	现
琺	琺	珐
琿	琿	珲
瑣	瑣	琐
瑤	瑤	瑶
瑩	瑩	莹
瑪	瑪	玛
瑯	瑯,琅	琅
環	環	环
璽	璽	玺
瓊	瓊	琼
瓏	瓏	珑
瓔	瓔	璎
甌	甌	瓯
甕	甕,瓮,罋	瓮
甦	甦,穌,蘇,囌	苏,稣
畝	畝	亩
畢	畢	毕
畫	畫,划,劃	划,画
異	異,异	异
當	當,噹	当
疇	疇	畴
疊	疊	叠
痙	痙	痉
痺	痺,痹	痹
痾	痾	疴
瘉	瘉,癒,愈	愈
瘋	瘋	疯
瘍	瘍	疡
瘡	瘡	疮
瘧	瘧,弄	疟,弄
療	療	疗
癆	癆	痨
癇	癇	痫
癒	癒,愈,瘉	愈
癘	癘	疠
癡	癡,痴	痴
癢	癢,痒	痒
癩	癩	癞
癬	癬	癣
癰	癰	痈
癲	癲,瘨	癫
發	發,髮	发
皚	皚	皑
皰	皰	疱
皸	皸	皲
皺	皺,縐	皱,绉
盃	盃,杯	杯
盜	盜	盗
盞	盞,醆	盏
盡	盡,儘	尽
監	監	监
盤	盤,槃	盘
盧	盧	卢
盪	盪,蕩,逿	荡
眥	眥	眦
瞞	瞞	瞒
瞭	瞭,了,暸	了
瞼	瞼	睑
矇	矇,蒙,濛,朦,懞	蒙,朦
矚	矚	瞩
矯	矯	矫
砲	砲,炮	炮
硯	硯	砚
碕	碕,崎,埼	崎
碩	碩	硕
碪	碪,砧	砧
確	確,确	确
碼	碼	码
磚	磚	砖
磧	磧	碛
磯	磯	矶
磽	磽,墝	硗
礎	礎	础
礙	礙	碍
礦	礦	矿
礪	礪	砺
礫	礫	砾
礬	礬	矾
祇	祇,只,衹,隻	只
祐	祐,佑	佑
祕	祕,秘	秘
祿	祿	禄
禍	禍	祸
禎	禎	祯
禦	禦,御	御
禪	禪	禅,单
禮	禮	礼
禰	禰,檷	祢
禿	禿	秃
稈	稈	秆
稜	稜,棱,楞	棱,楞
稟	稟,廩	禀,廪
種	種,种	种
稱	稱,偁,秤	称,秤
穀	穀,谷	谷
積	積	积
穎	穎,署	颖,署
穡	穡	穑
穢	穢	秽
穩	穩,文	稳,文
穫	穫,獲,檴	获
窩	窩	窝
窪	窪,洼	洼
窮	窮	穷
窯	窯	窑
窶	窶,寠	窭
窺	窺	窥
竄	竄	窜
竅	竅	窍
竇	竇	窦
竊	竊	窃
競	競	竞
筆	筆	笔
筍	筍	笋
筧	筧	笕
箇	箇,個	个
箋	箋,牋	笺
箏	箏	筝
節	節,樽	节,樽,卩
範	範,范,笵	范
築	築,筑	筑
篋	篋	箧
篠	篠,筱	筱
篤	篤	笃
篩	篩,簁	筛
篳	篳	筚
簀	簀	箦
簍	簍	篓
簑	簑,蓑	蓑
簡	簡,耕	简,耕
簣	簣,蕢	篑,蒉
簫	簫,燒,箾	箫,烧
簷	簷,檐	檐
簽	簽,籤	签
簾	簾,帘	帘
籃	籃,箖	篮
籌	籌	筹
籐	籐,藤	藤
籔	籔,藪	薮
籟	籟	籁
籠	籠	笼
籤	籤,簽	签
籥	籥,龠	龠
籬	籬,篱	篱
糞	糞	粪
糧	糧	粮
糲	糲	粝
糴	糴	籴
糶	糶,條	粜,条
糾	糾	纠
紀	紀	纪
紂	紂	纣
約	約	约
紅	紅	红
紆	紆	纡
紋	紋	纹
納	納	纳
紐	紐	纽
純	純	纯
紕	紕	纰
紗	紗	纱
紙	紙	纸
級	級	级
紛	紛	纷
紜	紜	纭
紡	紡	纺
紬	紬,綢	绸
紮	紮,扎	扎
細	細	细
紲	紲,絏	绁
紳	紳	绅
紹	紹	绍
紺	紺	绀
紿	紿	绐
終	終	终
絃	絃,弦	弦
組	組	组
絆	絆	绊
絎	絎	绗
絏	絏,紲	绁
結	結,揭	结,揭
絖	絖,纊	纩
絛	絛,縚	绦
絞	絞	绞
絡	絡	络
絢	絢	绚
絣	絣,背,揹	背
給	給	给
絨	絨	绒
統	統	统
絲	絲,糸	丝,纟,糸
絳	絳	绛,绦
絹	絹	绢
綏	綏	绥
經	經	经
綜	綜	综
綢	綢,紬	绸
綣	綣	绻
綬	綬	绶
維	維	维
綯	綯,褲	裤
綰	綰	绾
綱	綱	纲
網	網,网	网
綴	綴	缀
綵	綵,彩	彩
綸	綸	纶
綺	綺	绮
綻	綻	绽
綽	綽	绰
綾	綾	绫
綿	綿	绵
緇	緇	缁
緊	緊	紧
緋	緋	绯
緒	緒	绪
緘	緘	缄
線	線	线
緝	緝	缉
緞	緞	缎
締	締	缔
緡	緡,眠	缗,眠
編	編	编
緩	緩	缓
緬	緬	缅
緯	緯	纬
緲	緲,眇	缈,眇
練	練	练
緻	緻,致	致
縉	縉	缙
縊	縊	缢
縋	縋	缒
縛	縛	缚
縞	縞	缟
縟	縟,溽	缛,溽
縣	縣	县
縫	縫	缝
縮	縮	缩
縱	縱	纵
縲	縲,累,纍	缧,累
縵	縵	缦
縷	縷	缕
縹	縹	缥
總	總,摠	总
績	績,勣	绩
繃	繃	绷
繆	繆	缪
織	織	织
繕	繕	缮
繖	繖,傘	伞
繙	繙,翻	翻
繚	繚	缭
繞	繞,遶	绕
繩	繩	绳
繪	繪,繢	绘,缋
繭	繭,茧	茧
繰	繰,繅	缲,缫
繹	繹	绎
繼	繼	继
繽	繽	缤
纈	纈	缬
續	續	续
纏	纏	缠
纓	纓	缨
纔	纔,才	才
纖	纖,砌,縴	纤,砌
纜	纜	缆
罌	罌,甖,罃	罂
罰	罰	罚
罵	罵,傌	骂
罷	罷	罢
羃	羃,冪	幂
羅	羅,囉	罗
羆	羆	罴
羇	羇,羈	羁
羈	羈,羇	羁
羨	羨,羡	羡
義	義	义
羶	羶,膻	膻
習	習	习
翹	翹	翘
耡	耡,鋤	锄
聖	聖,堊,圣	圣,垩
聞	聞	闻
聯	聯	联
聰	聰	聪
聲	聲	声
聳	聳	耸
聶	聶	聂
職	職	职
聹	聹	聍
聽	聽,听	听
聾	聾	聋
肅	肅	肃
脅	脅,勰	胁,勰
脈	脈	脉
脛	脛	胫
脣	脣,唇	唇
脹	脹	胀
腎	腎	肾
腦	腦	脑
腫	腫,尰	肿
腸	腸	肠
膃	膃	腽
膚	膚	肤
膠	膠	胶
膩	膩	腻
膽	膽	胆
膾	膾,鱠	脍
膿	膿	脓
臉	臉	脸
臍	臍	脐
臘	臘,腊	腊
臙	臙,胭	胭
臚	臚	胪
臟	臟,髒	脏
臠	臠	脔
臥	臥	卧
臨	臨	临
臺	臺,台,檯,颱	台
與	與,与	与
興	興	兴
舉	舉	举
舊	舊	旧
舖	舖,鋪	铺
艙	艙	舱
艤	艤	舣
艦	艦	舰
艫	艫,櫓	舻,橹
艱	艱	艰
艷	艷,豔	艳
艸	艸,草	草,艹
芻	芻	刍
苧	苧,薴	苎
苺	苺,莓	莓
茲	茲,玆	兹
荅	荅,答	答
荊	荊	荆
荳	荳,豆	豆
莊	莊,庄	庄
莖	莖	茎
莢	莢	荚
菫	菫,堇	堇
華	華,崋	华
菴	菴,庵	庵
菻	菻,麻	麻
萇	萇	苌
萬	萬,万,卍	万
萵	萵	莴
葉	葉,協	叶
葦	葦	苇
葯	葯,藥	药
葷	葷	荤
蒔	蒔	莳
蒼	蒼	苍
蓆	蓆,席	席
蓋	蓋	盖
蓮	蓮	莲
蓴	蓴	莼
蔔	蔔,菔,卜	卜,菔
蔦	蔦	茑
蔭	蔭,廕	荫
蕁	蕁	荨
蕎	蕎,荍	荞
蕕	蕕	莸
蕘	蕘	荛
蕩	蕩,盪	荡
蕪	蕪	芜
蕭	蕭	萧
蕷	蕷	蓣
薈	薈	荟
薊	薊	蓟
薑	薑,姜	姜
薔	薔	蔷
薙	薙,剃	剃
薦	薦,荐	荐
薩	薩	萨
薺	薺	荠
藍	藍	蓝
藝	藝,埶,蓺,芸,蕓	艺,芸
藥	藥,葯	药
藪	藪,籔	薮
藷	藷,薯	薯
藹	藹	蔼
藺	藺	蔺
蘆	蘆	芦
蘇	蘇,囌,甦	苏
蘊	蘊,薀	蕴
蘋	蘋,苹	苹
蘚	蘚	藓
蘢	蘢	茏
蘭	蘭	兰
蘿	蘿	萝
處	處	处
虜	虜,擄	虏,掳
號	號	号
虧	虧	亏
蛻	蛻	蜕
蜆	蜆	蚬
蜑	蜑,蛋	蛋
蝕	蝕	蚀
蝟	蝟	猬
蝦	蝦	虾
蝨	蝨,虱	虱
蝸	蝸	蜗
螢	螢	萤
螻	螻	蝼
蟄	蟄	蛰
蟯	蟯	蛲
蟲	蟲,虫	虫
蟶	蟶	蛏
蟻	蟻,螘	蚁
蠅	蠅	蝇
蠍	蠍,蝎	蝎
蠑	蠑	蝾
蠣	蠣	蛎
蠱	蠱	蛊
蠶	蠶,蚕	蚕
蠻	蠻	蛮
衒	衒,炫	炫
術	術,朮	术
衛	衛	卫
衝	衝,沖	冲
袞	袞	衮
補	補	补
裝	裝	装
裡	裡,里	里
製	製,制	制
複	複,復,复,覆	复
褸	褸,蔞	褛,蒌
褻	褻	亵
襖	襖,澳	袄,澳
襠	襠	裆
襤	襤	褴
襪	襪	袜
襯	襯,儭	衬
襲	襲	袭
襾	襾,西	西
覈	覈,核	核
見	見	见
規	規,槻	规
覓	覓	觅
視	視	视
覘	覘	觇
覡	覡	觋
覦	覦	觎
親	親	亲
覬	覬	觊
覯	覯	觏
覲	覲	觐
覺	覺	觉
覽	覽	览
覿	覿	觌
觀	觀	观
觴	觴	觞
觸	觸,触	触
訂	訂	订
訃	訃	讣
計	計	计
訊	訊	讯
訌	訌	讧
討	討	讨
訐	訐	讦
訓	訓	训
訖	訖	讫
託	託,托,侂	托
記	記	记
訛	訛	讹
訝	訝	讶
訟	訟	讼
訣	訣	诀
訥	訥,吶	讷,呐
訪	訪	访
設	設	设
許	許	许
訴	訴,愬	诉
訶	訶,呵	诃,呵
診	診	诊
註	註,注	注
証	証,證	证
詁	詁	诂
詆	詆	诋
詐	詐,醡	诈
詒	詒	诒
詔	詔	诏
評	評	评
詛	詛	诅
詞	詞	词
詠	詠	咏
詢	詢	询
詣	詣	诣
試	試	试
詩	詩	诗
詫	詫	诧
詬	詬,呴	诟
詭	詭	诡
詮	詮	诠
詰	詰	诘
話	話	话
該	該	该
詳	詳	详
詼	詼	诙
誄	誄	诔
誅	誅	诛
誇	誇,侉,夸	夸,侉
誌	誌,志	志
認	認	认
誑	誑	诳
誕	誕	诞
誘	誘	诱
誚	誚,譙	诮,谯
語	語	语
誠	誠	诚
誡	誡	诫
誣	誣	诬
誤	誤	误
誥	誥	诰
誦	誦	诵
誨	誨	诲
誰	誰	谁
課	課	课
誹	誹	诽
誼	誼	谊
調	調	调
諂	諂	谄
諄	諄	谆
談	談,譚	谈,谭
請	請	请
諍	諍	诤
諏	諏	诹
諒	諒	谅
論	論	论
諛	諛	谀
諜	諜	谍
諞	諞	谝
諠	諠,喧	喧
諡	諡,謚	谥
諢	諢	诨
諤	諤,囮	谔
諦	諦	谛
諧	諧,龤	谐
諫	諫	谏
諭	諭	谕
諮	諮,咨	谘,咨
諱	諱	讳
諳	諳	谙
諷	諷	讽
諸	諸	诸
諺	諺	谚
諾	諾	诺
謀	謀	谋
謁	謁	谒
謂	謂	谓
謄	謄	誊
謎	謎	谜
謐	謐	谧
謔	謔	谑
謖	謖	谡
謗	謗	谤
謙	謙	谦
謚	謚,諡	谥
講	講	讲
謝	謝	谢
謠	謠	谣
謨	謨	谟
謫	謫	谪
謬	謬	谬
謳	謳	讴
謹	謹	谨
謾	謾	谩
譁	譁,嘩	哗
證	證,証	证
譎	譎,憰	谲
譏	譏	讥
譖	譖	谮
識	識	识
譚	譚,談	谭,谈
譜	譜	谱
譟	譟,噪	噪
譫	譫	谵
譯	譯	译
議	議	议
譴	譴	谴
護	護	护
譽	譽,域	誉,域
讀	讀	读
變	變	变
讌	讌,燕,宴	宴,燕
讎	讎,仇	雠,仇
讒	讒	谗
讓	讓	让
讖	讖	谶
讙	讙,歡	欢
讚	讚,贊	赞
谿	谿,溪	溪
豈	豈	岂
豊	豊,豐,丰	丰
豎	豎	竖
豐	豐,豊,丰	丰
豬	豬	猪
貍	貍,狸	狸
貝	貝	贝
貞	貞	贞
負	負	负
財	財,才,纔	财,才
貢	貢	贡
貧	貧	贫
貨	貨	货
販	販	贩
貪	貪	贪
貫	貫	贯
責	責,拆	责,拆
貯	貯	贮
貰	貰	贳
貲	貲	赀
貳	貳,二	贰,二
貴	貴	贵
貶	貶	贬
買	買	买
貸	貸	贷
費	費	费
貼	貼	贴
貽	貽	贻
貿	貿	贸
賀	賀	贺
賁	賁	贲
賂	賂	赂
賃	賃	赁
賄	賄	贿
資	資	资
賈	賈	贾
賊	賊	贼
賑	賑	赈
賓	賓	宾
賚	賚	赉
賜	賜	赐
賞	賞	赏
賠	賠	赔
賢	賢	贤
賣	賣	卖
賤	賤	贱
賦	賦	赋
質	質	质
賭	賭	赌
賺	賺	赚
賻	賻	赙
購	購	购
賽	賽	赛
贄	贄	贽
贅	贅	赘
贈	贈,憎	赠,憎
贊	贊,讚	赞
贍	贍	赡
贏	贏	赢
贐	贐,賮	赆
贓	贓	赃
贖	贖	赎
趙	趙	赵
趨	趨	趋
跡	跡,蹟,速	迹,速
踐	踐	践
踰	踰,逾	逾
踴	踴,踊	踊
蹌	蹌,牄	跄
蹕	蹕	跸
蹟	蹟,跡,速	迹,速
蹠	蹠,跖	跖
蹣	蹣	蹒
蹤	蹤	踪
躊	躊	踌
躋	躋,隮	跻
躍	躍,趯	跃
躑	躑	踯
躓	躓	踬
躡	躡	蹑
躪	躪	躏
車	車	车
軋	軋	轧
軌	軌	轨
軍	軍	军
軒	軒	轩
軛	軛	轭
軟	軟	软
軫	軫	轸
軸	軸	轴
軻	軻	轲
軼	軼	轶
軾	軾	轼
較	較	较
輅	輅	辂
載	載	载
輊	輊	轾
輒	輒	辄
輓	輓,挽	挽
輔	輔	辅
輕	輕	轻
輛	輛	辆
輜	輜	辎
輝	輝,煇	辉
輟	輟	辍
輦	輦,襜	辇
輩	輩	辈
輪	輪	轮
輯	輯	辑
輳	輳	辏
輸	輸	输
輻	輻	辐
輾	輾	辗
輿	輿,轝	舆
轂	轂	毂
轄	轄	辖
轅	轅	辕
轆	轆	辘
轉	轉	转
轍	轍	辙
轎	轎	轿
轟	轟	轰
轡	轡	辔
轢	轢,轣	轹
轤	轤	轳
辭	辭	辞
辮	辮	辫
辯	辯,辨,弁	辩,辨,弁
農	農	农
迴	迴,回	回
迺	迺,乃	乃
逕	逕,徑	迳,径
這	這	这
連	連,槤	连
週	週,周,賙	周
進	進	进
遊	遊,游	游
運	運	运
過	過	过
達	達	达
違	違	违
遙	遙	遥
遜	遜,愻	逊
遞	遞	递
遠	遠	远
適	適,适	适
遲	遲	迟
遶	遶,繞	绕
遷	遷	迁
選	選	选
遺	遺	遗
遼	遼	辽
邁	邁	迈
還	還	还
邇	邇	迩
邊	邊	边
邏	邏	逻
郤	郤	郄
郵	郵	邮
鄒	鄒	邹
鄭	鄭	郑
鄰	鄰	邻
鄲	鄲	郸
酖	酖,鴆	鸩
醜	醜,丑	丑
醫	醫,毉	医
釀	釀	酿
釁	釁,舋	衅
釆	釆,采,埰,採	采
釋	釋	释
釐	釐,厘,廛	厘,廛
釘	釘	钉
針	針,箴,鍼	针,箴
釣	釣	钓
釦	釦,扣	扣
釧	釧	钏
釵	釵,叉	钗,叉
鈍	鈍	钝
鈑	鈑	钣
鈔	鈔	钞
鈕	鈕	钮
鈞	鈞	钧
鈴	鈴	铃
鈷	鈷	钴
鈿	鈿	钿
鉅	鉅,巨	钜,巨
鉈	鉈,砣	铊,砣
鉉	鉉	铉
鉋	鉋,刨	刨
鉗	鉗,箝,鉆	钳,箝
鉚	鉚	铆
鉛	鉛,鈆	铅
鉞	鉞,戉	钺
鉤	鉤	钩
鉦	鉦	钲
銀	銀	银
銃	銃	铳
銅	銅	铜
銑	銑	铣
銓	銓	铨
銕	銕,鐵,鋨	铁,锇
銖	銖	铢
銘	銘	铭
銚	銚	铫
銜	銜,啣	衔
銷	銷	销
鋏	鋏	铗
鋒	鋒	锋
鋤	鋤,耡,鉏	锄
鋪	鋪,舖	铺
鋸	鋸	锯
鋼	鋼	钢
錆	錆	锖
錐	錐	锥
錘	錘,鎚	锤
錙	錙	锱
錚	錚	铮
錠	錠	锭
錢	錢	钱
錦	錦	锦
錨	錨	锚
錫	錫	锡
錮	錮	锢
錯	錯	错
鍋	鍋	锅
鍍	鍍	镀
鍔	鍔	锷
鍛	鍛	锻,煅
鍬	鍬	锹
鍵	鍵	键
鍼	鍼,箴,針	针,箴
鍾	鍾,鐘	钟,锺
鎌	鎌,鐮	镰
鎔	鎔,熔	熔
鎖	鎖	锁
鎗	鎗,槍	枪
鎚	鎚,錘	锤
鎧	鎧	铠
鎬	鎬	镐
鎮	鎮	镇
鎰	鎰	镒
鏃	鏃	镞
鏈	鏈	链
鏐	鏐,鎏	鎏
鏑	鏑	镝
鏗	鏗	铿
鏘	鏘	锵
鏝	鏝	镘
鏡	鏡	镜
鏤	鏤	镂
鏨	鏨	錾
鐃	鐃	铙
鐐	鐐	镣
鐓	鐓	镦
鐔	鐔	镡
鐘	鐘,鍾	钟,锺
鐙	鐙	镫
鐫	鐫,鋑,鑴	镌
鐵	鐵,銕,鋨	铁,锇
鐶	鐶,鍰	锾
鐸	鐸	铎
鐺	鐺	铛
鑄	鑄	铸
鑑	鑑,鑒	鉴,监
鑒	鑒,鑑	鉴,监
鑠	鑠,爍	铄,烁
鑰	鑰	钥
鑵	鑵,罐	罐
鑷	鑷	镊
鑼	鑼	锣
鑽	鑽,鉆	钻
鑾	鑾	銮
鑿	鑿	凿
钁	钁	镢
長	長	长
門	門	门
閂	閂	闩
閃	閃	闪
閉	閉	闭
開	開	开
閏	閏	闰
閑	閑	闲
間	間,閒	间
閔	閔	闵
閘	閘	闸
閣	閣	阁
閤	閤,合,闔,郃	阖,合
閥	閥	阀
閨	閨	闺
閭	閭	闾
閹	閹	阉
閻	閻,閆	阎,闫
閼	閼	阏
閾	閾	阈
闃	闃	阒
闇	闇,暗	暗
闊	闊	阔
闌	闌	阑
闔	闔,閤	阖
闕	闕	阙
闖	闖	闯
關	關,寡	关,寡
闡	闡	阐
闢	闢,辟	辟
闥	闥	闼
阨	阨,厄,呃	厄,呃
阯	阯,址	址
陏	陏,隋	隋
陜	陜,陝,狹	陕,狭
陝	陝,陜	陕
陞	陞,升,昇	升
陣	陣,陳	阵,陈
陰	陰	阴
陳	陳,陣	陈,阵
陸	陸,六	陆,六
陽	陽,昜	阳
隊	隊	队
階	階	阶
隕	隕,殞	陨,殒
際	際	际
隨	隨	随
險	險	险
隱	隱	隐
隴	隴	陇
隸	隸	隶
隻	隻,只,衹,祇	只
雋	雋	隽
雖	雖	虽
雙	雙	双
雛	雛,鶵	雏
雜	雜	杂
離	離,离	离
難	難	难
雰	雰,氛	氛
雲	雲,云	云
電	電	电
霑	霑,沾	沾
霧	霧	雾
霽	霽	霁
靂	靂	雳
靄	靄	霭
靈	靈	灵
靜	靜,靚	静,靓
靦	靦	腼
靨	靨	靥
鞏	鞏	巩
鞦	鞦,秋	秋
韃	韃	鞑
韆	韆,千,仟	千,仟
韋	韋	韦
韓	韓	韩
韜	韜,弢	韬
韻	韻	韵
響	響	响
頁	頁	页
頂	頂	顶
頃	頃	顷
項	項	项
順	順	顺
須	須,鬚	须
頌	頌	颂
頏	頏	颃
預	預,豫	预,豫
頑	頑	顽
頒	頒	颁
頓	頓	顿
頗	頗	颇
領	領	领
頡	頡	颉
頤	頤	颐
頭	頭	头
頷	頷	颔
頸	頸	颈
頻	頻	频
顆	顆	颗
題	題	题
額	額	额
顎	顎	颚
顏	顏	颜
願	願,愿	愿
顛	顛	颠
類	類	类
顧	顧	顾
顫	顫	颤
顯	顯	显
顰	顰,嚬	颦
顱	顱	颅
顳	顳	颞
顴	顴	颧
風	風,飌	风
颯	颯	飒
颱	颱,台,檯,臺	台
颶	颶	飓
飄	飄	飘
飆	飆	飙
飛	飛	飞
飢	飢,饑	饥
飩	飩	饨
飫	飫,饇	饫
飭	飭	饬
飯	飯	饭
飲	飲	饮
飴	飴	饴
飼	飼	饲
飽	飽	饱
飾	飾	饰
餃	餃	饺
餅	餅	饼
餉	餉,饟	饷
養	養	养
餌	餌	饵
餒	餒,餧	馁
餓	餓	饿
餔	餔,哺	哺
餘	餘,余	余,馀
餞	餞	饯
餡	餡	馅
館	館	馆
餽	餽,饋	馈
餾	餾	馏
饅	饅	馒
饉	饉	馑
饋	饋,餽,匱,櫃,柜	馈,匮,柜
饌	饌	馔
饑	饑,飢	饥
饒	饒	饶
饗	饗	飨
馬	馬	马
馭	馭,御,禦	驭,御
馮	馮	冯
馳	馳	驰
馴	馴	驯
駁	駁,駮	驳
駐	駐	驻
駑	駑	驽
駒	駒	驹
駕	駕	驾
駘	駘	骀
駛	駛	驶
駝	駝	驼
駟	駟	驷
駢	駢	骈
駭	駭	骇
駮	駮,駁	驳
駱	駱	骆
駿	駿	骏
騁	騁	骋
騅	騅	骓
騎	騎	骑
騏	騏	骐
騙	騙	骗
騫	騫	骞
騰	騰	腾
騷	騷	骚
騾	騾	骡
驀	驀	蓦
驂	驂	骖
驃	驃	骠
驅	驅,敺	驱
驍	驍	骁
驕	驕	骄
驗	驗	验
驚	驚,惊	惊
驛	驛	驿
驟	驟	骤
驢	驢	驴
驤	驤	骧
驥	驥	骥
驩	驩,歡	欢
驪	驪	骊
髏	髏	髅
體	體,体	体
髣	髣,仿,彷,倣	仿,彷
髮	髮,發	发
鬆	鬆,松	松
鬚	鬚,須	须
鬢	鬢	鬓
鬥	鬥,斗	斗,门
鬧	鬧	闹
鬨	鬨,哄	哄
鬩	鬩	阋
鬮	鬮	阄
鬱	鬱,郁	郁
魎	魎	魉
魘	魘	魇
魚	魚	鱼
魯	魯	鲁
魴	魴	鲂
鮑	鮑	鲍
鮒	鮒	鲋
鮪	鮪	鲔
鮫	鮫	鲛
鮭	鮭	鲑
鮮	鮮,尟	鲜
鯀	鯀	鲧
鯉	鯉	鲤
鯊	鯊,魦	鲨
鯔	鯔	鲻
鯖	鯖	鲭
鯛	鯛	鲷
鯡	鯡	鲱
鯢	鯢	鲵
鯤	鯤	鲲
鯨	鯨	鲸
鯰	鯰	鲇,鲶
鰈	鰈	鲽
鰉	鰉	鳇
鰍	鰍	鳅
鰒	鰒	鳆
鰓	鰓,腮	鳃,腮
鰥	鰥	鳏
鰭	鰭	鳍
鰲	鰲,鼇	鳌
鰹	鰹	鲣
鰻	鰻	鳗
鰾	鰾	鳔
鱈	鱈	鳕
鱒	鱒	鳟
鱗	鱗	鳞
鱠	鱠,膾	脍
鱧	鱧	鳢
鱸	鱸	鲈
鳥	鳥	鸟
鳧	鳧	凫
鳩	鳩	鸠
鳳	鳳	凤
鳴	鳴	鸣
鳶	鳶	鸢
鴆	鴆,酖	鸩
鴇	鴇	鸨
鴈	鴈,雁	雁
鴉	鴉	鸦
鴕	鴕	鸵
鴛	鴛	鸳
鴟	鴟	鸱
鴣	鴣	鸪
鴦	鴦	鸯
鴨	鴨	鸭
鴻	鴻	鸿
鴿	鴿	鸽
鵑	鵑	鹃
鵜	鵜	鹈
鵝	鵝	鹅
鵠	鵠	鹄
鵡	鵡	鹉
鵬	鵬	鹏
鵯	鵯	鹎
鵲	鵲	鹊
鶇	鶇	鸫
鶉	鶉	鹑
鶚	鶚	鹗
鶩	鶩	鹜
鶯	鶯	莺
鶴	鶴	鹤
鶻	鶻	鹘
鷂	鷂	鹞
鷓	鷓	鹧
鷙	鷙	鸷
鷦	鷦	鹪
鷯	鷯	鹩
鷲	鷲	鹫
鷸	鷸	鹬
鷹	鷹	鹰
鷺	鷺	鹭
鸚	鸚	鹦
鸛	鸛	鹳
鸞	鸞	鸾
鹵	鹵,滷	卤
鹹	鹹,咸	咸
鹽	鹽	盐
麗	麗	丽
麥	麥	麦
麩	麩	麸
麼	麼,么	么,麽
黌	黌	黉
點	點	点
黨	黨,党	党
黴	黴,霉	霉
黷	黷	黩
黽	黽	黾
鼇	鼇,鰲	鳌
鼕	鼕,冬	冬
齊	齊,齋	齐,斋
齋	齋,齊	斋,齐
齎	齎	赍
齏	齏	齑
齒	齒	齿
齔	齔	龀
齟	齟	龃
齠	齠	龆
齡	齡	龄
齦	齦,啃	龈,啃
齧	齧,嚙,囓	啮
齪	齪	龊
齬	齬	龉
齲	齲	龋
齶	齶	腭
齷	齷	龌
龍	龍,尨,龒	龙
龕	龕	龛
龜	龜	龟
个	個,箇	个
乱	亂	乱
争	爭	争
亘	亙	亘
从	從	从
会	會	会
侠	俠	侠
俣	俁	俣
偬	傯	偬
冂	坰	冂
内	內	内
册	冊	册
写	寫	写
冫	冰	冫,冰
冲	沖,衝	冲
决	決	决
况	況	况
凉	涼	凉
凛	凜,懍	凛,懔
凭	憑	凭
刹	剎	刹
剥	剝	剥
励	勵	励
勹	包	勹,包
区	區	区
医	醫,毉	医
卩	部,節	卩,部,节
却	卻	却
厦	廈	厦
厨	廚	厨
厩	廄	厩
厮	廝	厮
厶	私,某	厶,私,某
参	參	参
双	雙	双
叙	敘	叙
叶	葉,協	叶,协
号	號	号
咏	詠	咏
咤	吒	咤,吒
嘘	噓	嘘
嘱	囑	嘱
国	國	国
坂	阪	坂,阪
堕	墮	堕
壮	壯	壮
声	聲	声
奥	奧	奥
学	學	学
宝	寶	宝
寝	寢	寝
寿	壽	寿
将	將	将
尽	儘,盡	尽
届	屆	届
属	屬	属
屡	屢	屡
峡	峽	峡
巛	川	巛,川
幺	么,麼	幺,么,麽
广	廣	广
弃	棄	弃
弑	弒	弑
弥	彌,瀰	弥
弯	彎	弯
当	噹,當	当
彦	彥	彦
径	徑,逕	径,迳
恋	戀	恋
恒	恆	恒
悦	悅	悦
惧	懼	惧
惨	慘	惨
抛	拋	抛
担	擔	担
挟	挾	挟
掴	摑	掴
携	攜	携
攴	撲,扑	攴,扑,攵
数	數	数
断	斷	断
无	無	无
旧	舊	旧
昼	晝	昼
晋	晉	晋
条	條	条
来	來,徠	来,徕
枢	樞	枢
档	檔	档
桧	檜	桧
梦	夢	梦
椁	槨	椁
楼	樓	楼
横	橫	横
欧	歐	欧
残	殘	残
殴	毆	殴
没	沒	没
泪	淚	泪
浅	淺	浅
浜	濱	浜,滨
涛	濤	涛
渊	淵	渊
温	溫	温
湾	灣	湾
湿	濕,溼	湿
滞	滯	滞
潜	潛	潜
潴	瀦	潴
灯	燈	灯
炉	爐	炉
点	點	点
烟	煙,完,菸	烟,完,菸
状	狀	状
犹	猶	犹
独	獨	独
狭	狹	狭
猪	豬	猪
猫	貓	猫
献	獻	献
瑶	瑤	瑶
画	畫,划,劃	画,划
畴	疇	畴
疱	皰	疱
盖	蓋	盖
盗	盜	盗
眦	眥	眦
着	著	着,著
砺	礪	砺
碍	礙	碍
礼	禮	礼
祢	禰,檷	祢
祷	禱	祷
禀	稟	禀
禄	祿	禄
禅	禪	禅,单
称	稱	称
税	稅	税
窃	竊	窃
笋	筍	笋
筝	箏	筝
箪	簞	箪
粤	粵	粤
粮	糧	粮
耻	恥	耻
胆	膽	胆
脉	脈	脉
脚	腳	脚
脱	脫	脱
芦	蘆	芦
茎	莖	茎
莅	蒞	莅
莱	萊	莱
葱	蔥	葱
蒋	蔣	蒋
薮	藪,籔	薮
蘖	櫱,蘗,檗	蘖,檗
虚	虛	虚
蛎	蠣	蛎
蛮	蠻	蛮
蝉	蟬	蝉
装	裝	装
誉	譽	誉
践	踐	践
踪	蹤	踪
躯	軀	躯
辞	辭	辞
迩	邇	迩
迹	跡,蹟,速	迹,速
遥	遙	遥
随	隨	随
隶	隸	隶
静	靜	静
韵	韻	韵
麦	麥	麦
麸	麩	麸
黄	黃	黄
丗	世	世
両	兩	两
乕	虎	虎
乗	乘	乘
亀	龜	龟
亊	事	事
亜	亞	亚
亰	京	京
仏	佛,彿	佛
仭	仞	仞
仮	假	假
価	價,价	价
侫	佞	佞
侭	儘,盡	尽
値	值	值
倶	俱	俱
倹	儉	俭
偐	贗	赝
偸	偷	偷
働	動,仂	动,仂
僞	偽	伪
儁	俊	俊
兎	兔,菟	兔,菟
児	兒,儿	儿
兪	俞	俞
円	圓,元	圆,元
冐	冒	冒
冦	寇	寇
冨	富	富
冩	寫	写
凖	準,准,淮	准
処	處	处
凾	函	函
刄	刃	刃
刋	刊	刊
刔	抉	抉
刧	劫	劫
剣	劍	剑
剤	劑	剂
剰	剩	剩
剱	劍	剑
剳	札,劄	札
劒	劍	剑
劔	劍	剑
労	勞	劳
劵	券,倦	券,倦
効	效,傚	效
勅	敕	敕
勧	勸	劝
勲	勳,勛	勋
匳	奩	奁
卆	卒	卒
単	單	单
厠	廁	厕
厰	廠,厂	厂
厳	嚴	严
収	收	收
呉	吳	吴
呑	吞	吞
呪	咒	咒
咲	笑	笑
唖	啞	哑
啓	啟	启
喞	唧	唧
喩	喻	喻
喰	餐	餐
営	營	营
噐	器	器
嚔	嚏	嚏
嚠	瀏	浏
嚢	囊	囊
囘	回,迴	回
団	團,糰	团
囲	圍	围
図	圖	图
圀	國	国
圏	圈	圈
圧	壓	压
埀	垂	垂
埓	埒	埒
堺	界	界
塁	壘	垒
塩	鹽	盐
塲	場	场
増	增	增
墻	牆,廧	墙
壊	壞,坏	坏
壌	壤	壤
壜	罈,壇	坛
壱	壹	壹
売	賣	卖
壷	壺	壶
壻	婿	婿
変	變	变
夘	卯	卯
夛	多	多
夲	本	本
奨	獎	奖
奬	獎	奖
妬	妒	妒
姉	姊,姐	姊,姐
姙	妊	妊
姫	姬	姬
娚	喃	喃
娯	娛	娱
嫐	喃,嬲	喃,嬲
嫺	嫻	娴
嬢	娘,孃	娘
宍	肉	肉
実	實	实
寃	冤	冤
寛	寬	宽
寳	寶	宝
対	對	对
専	專,耑	专
尅	剋,克	克
尓	爾	尔
尠	鮮	鲜
尭	堯	尧
峩	峨	峨
峯	峰	峰
峺	硬	硬
崕	崖	崖
崘	崙,侖	仑
嵜	崎,埼,碕	崎
嵳	嵯	嵯
嶋	島	岛
嶌	島	岛
巌	巖,岩,嵒,碞	岩
巓	巔	巅
巣	巢	巢
巵	卮	卮
巻	卷,捲	卷
帋	紙	纸
帯	帶	带
帰	歸,皈	归,皈
幇	幫	帮
幤	幣	币
庁	廳	厅
広	廣,慶	广,庆
廃	廢	废
廏	廄	厩
廐	廄	厩
廰	廳	厅
廸	迪	迪
廻	回,迴	回
廼	乃,迺	乃
弉	奘	奘
弌	搋,一,壹	搋,一,壹
弍	二,貳	二,贰
弐	貳	贰
弾	彈	弹
彜	彝	彝
徃	往	往
従	從	从
徳	德	德
徴	徵,征	徵,征
応	應	应
忰	悴	悴
怱	匆	匆
恊	協,勰	协,勰
恠	怪	怪
恵	惠	惠
悋	吝	吝
悩	惱	恼
悪	惡,噁	恶
悳	德	德
愽	博	博
慂	恿	恿
慙	慚	惭
憇	憩	憩
憙	喜,歖	喜
懐	懷,怀	怀
懴	懺,忏	忏
戝	賊,財	贼,财
戞	戛	戛
戦	戰	战
戯	戲	戏
戸	戶	户
戻	戾	戾
払	拂	拂
抜	拔	拔
択	擇	择
拝	拜	拜
拠	據,据	据
拡	擴	扩
挙	舉	举
挿	插	插
捜	搜	搜
掲	揭	揭
掻	搔	搔
揺	搖	摇
摂	攝	摄
撃	擊	击
撹	攪	搅
擡	抬	抬
擧	舉	举
攅	攢	攒
敍	敘	叙
斈	學	学
斉	齊	齐
斎	齋	斋
昿	曠	旷
晄	晃	晃
晩	晚	晚
暁	曉	晓
暎	映	映
暦	曆,歷	历
曁	暨	暨
曵	曳,抴	曳
曽	曾	曾
朖	朗	朗
朞	期,稘	期
朶	朵	朵
枩	松,鬆	松
査	查	查
柾	柩	柩
栄	榮	荣
栢	柏,孛	柏,孛
桜	櫻	樱
桟	棧	栈
梹	檳	槟
梺	麓	麓
棊	棋	棋
椀	碗	碗
検	檢	检
椶	棕	棕
楕	橢	椭
楡	榆	榆
楳	梅	梅
楽	樂	乐
様	樣	样
権	權	权
欝	鬱,郁	郁
歓	歡	欢
歩	步	步
歯	齒	齿
歳	歲	岁
歴	歷,曆	历
殱	殲	歼
殻	殼	壳
毎	每	每
気	氣,气	气
氷	冰	冰,冫
汚	汙,洿,污	污
沢	澤	泽
浄	淨,凈	净
涙	淚	泪
涜	瀆	渎
渇	渴	渴
済	濟	济
渉	涉	涉
渋	澀	涩
渓	溪,谿	溪
渕	淵	渊
満	滿	满
溌	潑	泼
漑	溉	溉
潅	灌	灌
澁	澀,濇	涩
澑	溜,霤	溜
濳	潛	潜
濶	闊	阔
瀬	瀨	濑
烱	炯	炯
焔	焰,燄	焰
焼	燒	烧
煕	熙	熙
熈	熙	熙
燗	爛	烂
爲	為	为
爼	俎	俎
牀	床	床
犂	犁,犛	犁
犇	奔	奔
犠	犧	牺
犲	豺	豺
狢	貉	貉
猟	獵	猎
獣	獸	兽
珎	珍	珍
瑠	琉	琉
璢	琉	琉
甎	磚	砖
甞	嘗,嚐	尝
産	產	产
畄	留	留
畆	畝	亩
畊	耕	耕
畍	界	界
畧	略	略
畭	畬	畲
畳	疊	叠
疉	疊	叠
疎	疏	疏
痩	瘦	瘦
瘻	瘺	瘘
癨	霍	霍
発	發,髮	发
皃	貌	貌
皐	皋,睾,睪	皋,睾
皷	鼓	鼓
県	縣	县
眞	真	真
瞹	曖	暧
砕	碎	碎
砿	礦	矿
碁	棋	棋
碯	瑙	瑙
磆	滑	滑
稲	稻	稻
稾	稿	稿,藁
穂	穗	穗
穉	稚	稚
穏	穩	稳
穐	秋,鞦	秋
穣	穰	穰
穽	阱	阱
窓	窗	窗
窰	窯	窑
竃	灶	灶
竈	灶	灶
竒	奇	奇
竚	佇	伫
竜	龍	龙
竝	並,并,併	并
竢	俟	俟
竪	豎	竖
竸	競	竞
笶	矢	矢
筺	筐	筐
箒	帚	帚
篭	籠	笼
簒	篡	篡
籖	籤,簽	签
粃	秕	秕
粋	粹	粹
粛	肅	肃
粧	妝	妆
粫	糯	糯
糺	糾	纠
絋	纊	纩
経	經	经
絵	繪	绘
絶	絕	绝
綉	繡	绣
継	繼	继
続	續	续
綫	線	线
総	總	总
緑	綠	绿
緜	綿	绵
緤	紲	绁
縁	緣	缘
縄	繩	绳
縦	縱	纵
繊	纖,縴	纤
繋	繫,系,係	系
繍	繡	绣
繦	繈,襁	襁
繿	襤	褴
纉	纘	缵
纎	纖,縴	纤
纒	纏	缠
罸	罰	罚
羣	群	群
羮	羹	羹
翆	翠	翠
聟	婿	婿
聡	聰	聪
聨	聯	联
聴	聽,听	听
肬	疣	疣
脇	脅	胁
脳	腦	脑
腟	膣	膣
膓	腸	肠
膸	髓	髓
臈	臘,腊	腊
臓	髒,臟	脏
舎	舍,捨	舍
舗	鋪,舖	铺
舘	館	馆
舩	船	船
舮	櫓,艫	橹,舻
艢	檣	樯
艪	櫓	橹
艶	豔,艷	艳
苅	刈	刈
茘	荔	荔
荘	莊,庄	庄
莵	菟,兔	菟,兔
菓	果	果
菷	帚	帚
萠	萌	萌
葢	蓋	盖
蒭	芻	刍
蔵	藏	藏
蕋	蕊	蕊
蕚	萼	萼
薫	薰	薰
薬	藥,葯	药
蘂	蕊	蕊
蘓	蘇,甦,囌	苏
蘯	盪,蕩	荡
蛍	螢	萤
蝋	蠟,蜡	蜡
蝿	蠅	蝇
蟇	蟆	蟆
蠎	蟒	蟒
蠏	蟹	蟹
蠧	蠹	蠹
衂	衄	衄
衆	眾	众
衞	衛	卫
袴	褲	裤
袵	衽	衽
裏	裹,裡,里	里,裹
襃	褒	褒
襍	雜	杂
覇	霸	霸
覊	羈,羇	羁
覚	覺	觉
覧	覽	览
覩	睹	睹
観	觀	观
觧	解	解
訳	譯	译
説	說	说
読	讀	读
諌	諫	谏
謌	歌	歌
謡	謠	谣
譌	訛	讹
譱	善	善
譲	讓	让
讃	讚,贊	赞
讐	仇,讎	仇,雠
貭	質	质
貮	二,貳	二,贰
賍	贓	赃
賛	贊,讚	赞
贋	贗	赝
赱	走	走
躰	體,体	体
躱	躲	躲
軆	體,体	体
転	轉	转
軣	轟	轰
軽	輕	轻
輌	輛,軜	辆
輙	輒	辄
辧	辨,弁	辨,弁
辺	邊	边
迯	逃	逃
逓	遞	递
逹	達	达
遅	遲	迟
遡	溯,泝	溯
邉	邊	边
邨	村	村
郷	鄉	乡
酔	醉	醉
醤	醬	酱
醸	釀	酿
釈	釋	释
釖	劍	剑
釡	釜	釜
釼	劍	剑
鈎	鉤	钩
鈬	鐸	铎
鉄	鐵,銕,鋨	铁,锇
鉢	缽	钵
鉱	礦,磺	矿,磺
銭	錢	钱
銹	鏽	锈
鋭	銳	锐
鋳	鑄	铸
錬	煉,鍊	炼,链
録	錄	录
鎭	鎮	镇
鏥	鏽	锈
鐡	鐵,銕,鋨	铁,锇
鑚	鑽	钻
鑛	礦	矿
閇	閉	闭
閙	鬧	闹
関	關	关
閧	哄,鬨	哄
閲	閱	阅
闘	鬥,斗	斗
陥	陷	陷
険	險	险
隠	隱	隐
隣	鄰	邻
隲	騭	骘
隷	隸	隶
雑	雜	杂
霊	靈	灵
靭	韌	韧
靱	韌	韧
韈	襪	袜
韮	韭	韭
韲	齏	齑
頚	頸	颈
頬	頰	颊
頴	穎	颖
頼	賴	赖
頽	頹	颓
顋	腮,鰓	腮,鳃
顔	顏	颜
顕	顯	显
飃	飄	飘
飜	翻	翻
飮	飲	饮
餝	飾	饰
餠	餅	饼
駄	馱	驮
駅	驛	驿
駆	驅	驱
駈	驅	驱
騒	騷	骚
験	驗	验
髄	髓	髓
髪	髮,發	发
髴	彿,佛	佛
鬪	鬥,斗	斗
鮎	鯰	鲇
鰌	鰍,魷	鳅,鱿
鰐	鱷	鳄
鰕	蝦	虾
鳫	雁,鴈	雁
鳬	鳧	凫
鴎	鷗	鸥
鴬	鶯	莺
鵞	鵝	鹅
鶏	雞	鸡
鷄	雞,鳼	鸡
鹸	鹼,堿	硷,碱
麁	粗,麤	粗
麕	麇	麇
麪	麵,面	面
麹	麴	麴
麺	麵,面	面
黒	黑	黑
黙	默	默
鼈	鱉	鳖
鼡	鼠	鼠
齢	齡	龄
龝	秋,鞦	秋
丱	丱	N/A
乂	乂	N/A
亶	亶	N/A
伜	倅	N/A
侘	侘	N/A
俔	俔	N/A
俛	俛	N/A
俵	俵	N/A
俶	俶	N/A
倅	倅	N/A
偲	偲	N/A
儚	儚	N/A
冏	冏,囧	N/A
冓	冓	N/A
剏	刱	N/A
劼	劼	N/A
勍	勍	N/A
吽	吽	N/A
呎	呎,尺	尺
呰	呰	N/A
咢	咢	N/A
咾	咾	N/A
哢	哢	N/A
啀	啀	N/A
啅	啅	N/A
喨	喨	N/A
嗹	嗹	N/A
噂	噂,譐	N/A
囃	囃	N/A
埆	埆	N/A
埣	埣	N/A
堽	堽,崗,岡	岗,冈
塙	塙	N/A
墺	墺	N/A
壼	壼	N/A
夐	敻	N/A
夬	夬	N/A
姶	姶	N/A
娵	娵	N/A
嫋	嫋,嬝	N/A
嬬	嬬	N/A
孅	孅	N/A
屓	屭	N/A
岨	岨,砠	N/A
岶	岶	N/A
峇	峇	N/A
崚	崚	N/A
崟	崟,嶔	N/A
嵎	嵎	N/A
嵒	嵒,岩,巖,碞	岩
嶢	嶢	N/A
嶬	嶬	N/A
嶮	嶮	N/A
幎	幎	N/A
廱	廱,雝	痈
弸	弸	N/A
怐	怐	N/A
悁	悁,懁	N/A
悗	悗	N/A
惓	惓	N/A
愃	愃	N/A
慇	慇,殷	殷
慓	慓	N/A
慥	慥	N/A
慱	慱	N/A
慴	慴	N/A
憖	憖	N/A
憺	憺	N/A
懆	懆	N/A
拑	拑	N/A
拵	拵	N/A
挌	挌	N/A
捗	捗	N/A
掟	掟	N/A
掫	掫	N/A
揃	揃	N/A
摎	摎	N/A
擽	擽	揽
旡	旡	N/A
旻	旻	N/A
晞	晞,曦	曦
暘	暘,昜	阳
曚	曚	N/A
朏	朏	N/A
朸	朸,扐	N/A
朿	朿,莿	N/A
杙	杙	N/A
枅	枅	N/A
枌	枌	N/A
枹	枹	N/A
柊	柊	N/A
柎	柎	N/A
柤	柤	N/A
柧	柧	N/A
柮	柮	N/A
栫	栫	N/A
栴	栴	N/A
桍	桍	N/A
桾	桾	N/A
梛	梛	N/A
梠	梠	N/A
梱	梱	N/A
梼	檮	N/A
棆	棆	N/A
棔	棔	N/A
棡	棡	N/A
棯	棯	N/A
椄	椄	N/A
椈	椈	N/A
椌	椌	N/A
椥	椥	N/A
椪	椪	N/A
楢	楢	N/A
楪	楪	N/A
楯	楯	N/A
楴	楴	N/A
榎	榎,檟	N/A
榑	榑	N/A
榠	榠	N/A
榾	榾	N/A
槇	槙	N/A
槙	槙	N/A
槫	槫	N/A
樔	樔	N/A
樛	樛	N/A
橿	橿	N/A
檍	檍	N/A
檮	檮	N/A
櫑	櫑,罍	N/A
歔	歔	N/A
殕	殕	N/A
汳	汳	N/A
沚	沚	N/A
沺	沺	N/A
泙	泙,洴	N/A
洸	洸	N/A
浤	浤	N/A
浬	浬,里,裡	里
淕	淕	N/A
渟	渟	N/A
渮	渮	N/A
湲	湲	N/A
滉	滉	N/A
澪	澪	N/A
濆	濆	N/A
濔	濔	N/A
烋	烋	N/A
焜	焜	N/A
燐	燐,磷	磷
牴	牴,觝,抵,扺	抵
狆	狆	N/A
珸	珸	N/A
琲	琲	N/A
瑳	瑳	N/A
瓩	瓩	N/A
甃	甃	N/A
畤	畤	N/A
畷	畷	N/A
痲	痲,痳,麻	麻
痳	痳,痲,麻	麻
癈	癈	N/A
癪	癪	N/A
盻	盻	N/A
眛	眛	N/A
瞋	瞋	N/A
瞶	瞶	N/A
矼	矼	N/A
砠	砠,岨	N/A
碆	碆	N/A
磑	磑	N/A
礑	礑	N/A
礒	礒	N/A
秬	秬	N/A
稘	稘	N/A
稙	稙	N/A
笘	笘	N/A
笵	笵,範,范	范
筈	筈	N/A
筥	筥	N/A
筰	筰	N/A
筴	筴	N/A
箘	箘	N/A
箙	箙	N/A
簔	簑,蓑	蓑
籘	籐,藤	藤
籵	籵	N/A
粁	粁	N/A
粍	粍	N/A
粡	粡	N/A
粨	粨	N/A
糎	糎	N/A
糒	糒	N/A
糢	糢	馍
紘	紘	N/A
紵	紵	N/A
絅	絅,褧	N/A
絽	絽	N/A
綟	綟	N/A
縒	縒	N/A
縡	縡	N/A
縢	縢	N/A
縺	縺	N/A
繻	繻	N/A
罍	罍,櫑	N/A
罠	罠	N/A
罧	罧	N/A
罫	罫	N/A
羂	罥	N/A
翫	翫	N/A
脩	脩,修	修
膕	膕	N/A
膰	膰	N/A
膵	膵	N/A
臑	臑	N/A
艀	艀	N/A
苙	苙	N/A
苳	苳	N/A
茖	茖	N/A
荵	荵	N/A
莇	莇	N/A
莚	莚	N/A
菎	菎	N/A
萓	萓	N/A
萩	萩	N/A
葎	葎	N/A
葮	葮	N/A
葹	葹	N/A
蒐	蒐	N/A
蒟	蒟	N/A
蒻	蒻	N/A
蔀	蔀	N/A
蔆	蔆,菱	菱
蔕	蔕,蒂	蒂
蔘	蔘	N/A
蕀	蕀	N/A
蕗	蕗	N/A
蕣	蕣	N/A
薀	薀,蘊	蕴
薐	薐	N/A
藾	藾	N/A
蘗	蘗,檗,櫱	蘖,檗
蛬	蛬	N/A
蝪	蝪	N/A
蟷	蟷,螳	螳
衵	衵	N/A
袗	袗	N/A
袙	袙	N/A
裲	裲	N/A
褌	褌	N/A
褞	褞	N/A
襌	襌	N/A
襭	襭	N/A
襴	襴	N/A
覗	覗	N/A
觝	觝,牴	N/A
詑	詑	N/A
誂	誂	N/A
贇	贇	N/A
贔	贔	N/A
跂	跂	N/A
跼	跼,局,侷,挶	局
跿	跿	N/A
蹐	蹐	N/A
躄	躄	N/A
輹	輹	N/A
轗	轗	N/A
轣	轣,轢	轹
辿	辿	N/A
遉	遉	N/A
遯	遯	N/A
酘	酘	N/A
酳	酳	N/A
醂	醂	N/A
醗	醱	N/A
釿	釿	N/A
鉐	鉐	N/A
鉾	鉾	N/A
銛	銛	N/A
鋩	鋩	N/A
鋺	鋺	N/A
錏	錏	N/A
錣	錣	N/A
錵	錵	N/A
鍖	鍖	N/A
鍜	鍜,煆	N/A
鍠	鍠	N/A
鐇	鐇	N/A
鑞	鑞	N/A
鑢	鑢	N/A
鑪	鑪	N/A
闍	闍	N/A
霙	霙	N/A
霤	霤,溜	溜
靆	靆	N/A
靉	靉	N/A
靺	靺	N/A
鞁	鞁	N/A
鞄	鞄	N/A
鞜	鞜	N/A
鞨	鞨	N/A
鞳	鞳	N/A
餤	餤	N/A
餬	餬	N/A
饐	饐	N/A
駸	駸	N/A
駻	駻	N/A
騨	驒	N/A
驫	驫	N/A
骭	骭	N/A
髱	髱	N/A
髷	髷	N/A
鬘	鬘	N/A
鮓	鮓	N/A
鮠	鮠	N/A
鮨	鮨	N/A
鮹	鮹	N/A
鯆	鯆	N/A
鰆	鰆	N/A
鰔	鰔	N/A
鰡	鰡	N/A
鰤	鰤	N/A
鱆	鱆	N/A
鴃	鴃,鵙	N/A
鴒	鴒	N/A
鴾	鴾	N/A
鵁	鵁	N/A
鵙	鵙,鴃,鶪	N/A
鶤	鶤	N/A
鶲	鶲	N/A
鶸	鶸	N/A
鶺	鶺	N/A
鷁	鷁	N/A
鷆	鷏	N/A
鷏	鷏	N/A
鷭	鷭	N/A
鷽	鷽	N/A
麌	麌	N/A
麑	麑	N/A
麭	麭	N/A
黐	黐	N/A
黶	黶	N/A
齣	齣,出	出
丶	N/A	丶
丿	N/A	丿
亠	N/A	亠
冖	N/A	冖
夂	N/A	夂
夊	N/A	攵
宀	N/A	宀
廴	N/A	廴
彑	N/A	彐
彡	N/A	彡
攵	N/A	攵,攴
痃	N/A	痃
癧	N/A	疬
藁	稿	藁,稿
鞴	N/A	鞴
鮃	N/A	鲆
乢	N/A	N/A
亅	N/A	N/A
俤	N/A	N/A
俥	N/A	N/A
偖	N/A	N/A
儖	N/A	N/A
冴	冱,沍	冱
凧	N/A	N/A
凩	N/A	N/A
凪	N/A	N/A
勠	N/A	N/A
匁	N/A	N/A
匂	N/A	N/A
匸	N/A	N/A
叺	N/A	N/A
呟	N/A	N/A
哘	N/A	N/A
啌	N/A	N/A
啝	N/A	N/A
噛	嚙	啮
噺	N/A	N/A
嚊	N/A	N/A
囎	N/A	N/A
圦	N/A	N/A
圷	N/A	N/A
圸	N/A	N/A
坿	N/A	N/A
垈	N/A	N/A
垉	N/A	N/A
垪	N/A	N/A
垰	N/A	N/A
垳	N/A	N/A
埖	N/A	N/A
塀	N/A	N/A
塰	N/A	N/A
墸	N/A	N/A
墹	N/A	N/A
壗	N/A	N/A
壥	N/A	N/A
妛	N/A	N/A
嬶	N/A	N/A
寉	N/A	N/A
屶	N/A	N/A
岻	N/A	N/A
岼	N/A	N/A
岾	N/A	N/A
峅	N/A	N/A
峠	N/A	N/A
嵶	N/A	N/A
嶐	N/A	N/A
弖	N/A	N/A
彁	N/A	N/A
怺	N/A	N/A
恷	N/A	N/A
悧	N/A	N/A
惣	N/A	N/A
愡	N/A	N/A
愼	慎	慎
慯	N/A	N/A
扨	扠,叉	叉
抂	N/A	N/A
挧	N/A	N/A
掵	N/A	N/A
擶	N/A	N/A
旙	旛	N/A
晧	N/A	N/A
暃	N/A	N/A
暼	N/A	N/A
朷	N/A	N/A
杁	朳	N/A
杢	N/A	N/A
杣	N/A	N/A
杤	N/A	N/A
枠	N/A	N/A
枡	N/A	N/A
枦	櫨	栌
栂	N/A	N/A
栃	N/A	N/A
栞	N/A	N/A
桙	N/A	N/A
桝	N/A	N/A
梍	N/A	N/A
梶	N/A	N/A
椙	N/A	N/A
椚	N/A	N/A
椛	N/A	N/A
椡	N/A	N/A
椢	N/A	N/A
椣	N/A	N/A
椦	N/A	N/A
椨	N/A	N/A
楾	N/A	N/A
榁	N/A	N/A
榊	N/A	N/A
榲	N/A	N/A
槝	N/A	N/A
槞	櫳	栊
槹	N/A	N/A
樋	N/A	N/A
樌	N/A	N/A
樒	N/A	N/A
樢	N/A	N/A
樫	N/A	N/A
樮	N/A	N/A
樶	N/A	N/A
橲	N/A	N/A
橸	N/A	N/A
檪	櫟	栎
櫁	N/A	N/A
欅	N/A	榉
欟	N/A	N/A
毟	N/A	N/A
汢	N/A	N/A
湶	N/A	N/A
溂	N/A	N/A
滝	瀧	泷
瀞	N/A	N/A
熕	N/A	N/A
燵	N/A	N/A
狛	N/A	N/A
猯	N/A	N/A
獏	貘	貘
珱	瓔	璎
瓧	N/A	N/A
瓰	N/A	N/A
瓱	N/A	N/A
瓲	N/A	N/A
瓸	N/A	N/A
甅	N/A	N/A
甼	町	町
畉	N/A	N/A
畑	N/A	N/A
畠	N/A	N/A
畩	N/A	N/A
疂	疊	叠
癶	N/A	N/A
皀	N/A	N/A
皹	皸	皲
眤	N/A	N/A
硲	N/A	N/A
硴	N/A	N/A
碵	N/A	N/A
礇	N/A	N/A
禝	N/A	N/A
秡	N/A	N/A
穃	N/A	N/A
竍	N/A	N/A
竏	N/A	N/A
竓	N/A	N/A
竕	N/A	N/A
竡	N/A	N/A
竰	N/A	N/A
笂	N/A	N/A
笹	N/A	N/A
筬	N/A	N/A
箆	篦	篦
箚	N/A	N/A
箟	箘	N/A
篏	嵌	嵌
篶	N/A	N/A
簓	N/A	N/A
簗	N/A	N/A
籏	旗	旗
籾	N/A	N/A
粂	N/A	N/A
粐	N/A	N/A
粭	N/A	N/A
糀	N/A	N/A
糂	N/A	N/A
糘	N/A	N/A
綛	N/A	N/A
緕	N/A	N/A
縅	N/A	N/A
繝	N/A	N/A
繧	N/A	N/A
纃	N/A	N/A
纐	N/A	N/A
罎	N/A	N/A
聢	N/A	N/A
膤	N/A	N/A
艝	N/A	N/A
茣	N/A	N/A
莟	N/A	N/A
萢	N/A	N/A
萪	N/A	N/A
蒄	N/A	N/A
蓙	N/A	N/A
蓚	N/A	N/A
薗	園	园
蘰	N/A	N/A
蚫	N/A	N/A
蛯	N/A	N/A
蟐	N/A	N/A
袮	N/A	N/A
袰	N/A	N/A
袿	N/A	N/A
裃	N/A	N/A
裄	N/A	N/A
褄	N/A	N/A
褝	襌	N/A
襷	N/A	N/A
諚	N/A	N/A
譛	譖	谮
谺	N/A	N/A
豼	貔	貔
貎	猊	猊
賎	賤	贱
踈	N/A	N/A
躙	躪	躏
躾	N/A	N/A
軅	N/A	N/A
軈	N/A	N/A
轌	N/A	N/A
轜	N/A	N/A
辷	N/A	N/A
辻	N/A	N/A
込	N/A	N/A
迚	N/A	N/A
逎	遒	遒
逧	N/A	N/A
遖	N/A	N/A
釛	N/A	N/A
釟	N/A	N/A
釶	N/A	N/A
鈩	鑪	N/A
鋲	N/A	N/A
錺	N/A	N/A
錻	N/A	N/A
鍄	N/A	N/A
鍮	N/A	N/A
鎹	N/A	N/A
鐚	N/A	N/A
鑁	N/A	N/A
鑓	N/A	N/A
閊	N/A	N/A
閖	N/A	N/A
閠	閏	闰
陦	N/A	N/A
雫	N/A	N/A
靤	皰	疱
靫	N/A	N/A
靹	N/A	N/A
鞆	N/A	N/A
鞐	N/A	N/A
颪	N/A	N/A
饂	N/A	N/A
馼	N/A	N/A
駲	N/A	N/A
髞	N/A	N/A
髢	N/A	N/A
鮖	N/A	N/A
鮗	N/A	N/A
鮟	N/A	N/A
鮴	N/A	N/A
鯏	N/A	N/A
鯑	N/A	N/A
鯒	N/A	N/A
鯣	N/A	N/A
鯱	N/A	N/A
鯲	N/A	N/A
鯵	N/A	N/A
鰄	N/A	N/A
鰊	N/A	N/A
鰛	N/A	N/A
鰮	N/A	N/A
鰯	N/A	N/A
鰰	N/A	N/A
鰺	N/A	N/A
鱇	N/A	N/A
鱚	N/A	N/A
鱶	N/A	N/A
鳰	N/A	N/A
鴪	N/A	N/A
鴫	N/A	N/A
鵄	鴟	鸱
鵆	N/A	N/A
鵈	N/A	N/A
鵐	N/A	N/A
鵤	N/A	N/A
鵺	N/A	N/A
鶫	鶇	鸫
麿	N/A	N/A
